乙酰半胱氨酸注射液|乙酰半胱氨酸注射液
青龙蛇药片|青龙蛇药片
麝香活血化瘀膏|麝香活血化瘀膏
盐酸氯胺酮注射液|盐酸氯胺酮注射液
盐酸曲马多氯化钠注射液|盐酸曲马多氯化钠注射液
盐酸昂丹司琼氯化钠注射液|盐酸昂丹司琼氯化钠注射液
帕拉米韦氯化钠注射液|帕拉米韦氯化钠注射液
酒石酸唑吡坦分散片|酒石酸唑吡坦分散片
注射用盐酸纳洛酮|注射用盐酸纳洛酮
盐酸麻黄碱注射液|盐酸麻黄碱注射液
阿普唑仑片|阿普唑仑片
托拉塞米分散片|托拉塞米分散片
苯巴比妥钠注射液|苯巴比妥钠注射液
达肝素钠注射液|达肝素钠注射液
棓丙酯氯化钠注射液|棓丙酯氯化钠注射液
注射用盐酸氯普鲁卡因|注射用盐酸氯普鲁卡因
艾司唑仑片|艾司唑仑片
复方茶碱甲麻黄碱片|复方茶碱甲麻黄碱片
麦角胺咖啡因片|麦角胺咖啡因片
硫酸吗啡片|硫酸吗啡片
阿德福韦酯分散片|阿德福韦酯分散片
注射用苯巴比妥钠|注射用苯巴比妥钠
磷酸可待因注射液|磷酸可待因注射液
盐酸阿扑吗啡注射液|盐酸阿扑吗啡注射液
注射用异戊巴比妥钠|注射用异戊巴比妥钠
氯硝西泮注射液|氯硝西泮注射液
棕榈哌泊塞嗪注射液|棕榈哌泊塞嗪注射液
氟芬那酸片|氟芬那酸片
齐多夫定口服溶液|齐多夫定口服溶液
盐酸麻黄碱滴鼻剂|盐酸麻黄碱滴鼻剂
注射用因卡膦酸二钠|注射用因卡膦酸二钠
佐米曲普坦分散片|佐米曲普坦分散片
乙胺嘧啶片|乙胺嘧啶片
润燥止痒胶囊|润燥止痒胶囊
枸橼酸铋雷尼替丁片|枸橼酸铋雷尼替丁片
参倍固肠胶囊|参倍固肠胶囊
九味肝泰胶囊|九味肝泰胶囊
兰索拉唑片|兰索拉唑片
艾司奥美拉唑镁肠溶片|艾司奥美拉唑镁肠溶片
瑞巴派特片|瑞巴派特片
胃康胶囊|胃康胶囊
安胃疡胶囊|安胃疡胶囊
摩罗丹|摩罗丹
泛昔洛韦分散片|泛昔洛韦分散片
格列喹酮分散片|格列喹酮分散片
芪明颗粒|芪明颗粒
木丹颗粒|木丹颗粒
阿卡波糖片|阿卡波糖片
消渴丸|消渴丸
格列吡嗪控释片|格列吡嗪控释片
罗格列酮钠片|罗格列酮钠片
伏格列波糖分散片|伏格列波糖分散片
盐酸金霉素眼膏|盐酸金霉素眼膏
麝珠明目滴眼液|麝珠明目滴眼液
和血明目片|和血明目片
鱼腥草滴眼液|鱼腥草滴眼液
注射用头孢曲松钠他唑巴坦钠|注射用头孢曲松钠他唑巴坦钠
坎地沙坦酯分散片|坎地沙坦酯分散片
氢溴酸加兰他敏缓释片|氢溴酸加兰他敏缓释片
葛兰心宁软胶囊|葛兰心宁软胶囊
致康胶囊|致康胶囊
氨甲环酸片|氨甲环酸片
地高辛片|地高辛片
马来酸依那普利分散片|马来酸依那普利分散片
养心生脉颗粒|养心生脉颗粒
灯盏生脉胶囊|灯盏生脉胶囊
厄贝沙坦氢氯噻嗪分散片|厄贝沙坦氢氯噻嗪分散片
保利尔胶囊|保利尔胶囊
松龄血脉康胶囊|松龄血脉康胶囊
心悦胶囊|心悦胶囊
银丹心脑通软胶囊|银丹心脑通软胶囊
冠心舒通胶囊|冠心舒通胶囊
阿托伐他汀钙片|阿托伐他汀钙片
速效救心丸|速效救心丸
复方利血平氨苯蝶啶片|复方利血平氨苯蝶啶片
血脂康胶囊|血脂康胶囊
瑞舒伐他汀钙片|瑞舒伐他汀钙片
马来酸左旋氨氯地平片|马来酸左旋氨氯地平片
养心氏片|养心氏片
复方血栓通胶囊|复方血栓通胶囊
麝香保心丸|麝香保心丸
盐酸普罗帕酮片|盐酸普罗帕酮片
盐酸美西律片|盐酸美西律片
培元通脑胶囊|培元通脑胶囊
巴氯芬片|巴氯芬片
雷米普利片|雷米普利片
升血小板胶囊|升血小板胶囊
芪苈强心胶囊|芪苈强心胶囊
脑血疏口服液|脑血疏口服液
地奥心血康胶囊|地奥心血康胶囊
普罗布考片|普罗布考片
参松养心胶囊|参松养心胶囊
天麻钩藤颗粒|天麻钩藤颗粒
福辛普利钠片|福辛普利钠片
泌淋清胶囊|泌淋清胶囊
盐酸咪达普利片|盐酸咪达普利片
盐酸地尔硫䓬片|盐酸地尔硫䓬片
七十味珍珠丸|七十味珍珠丸
芪参益气滴丸|芪参益气滴丸
脉平片|脉平片
硫酸氢氯吡格雷片|硫酸氢氯吡格雷片
溴芬酸钠滴眼液|溴芬酸钠滴眼液
苯磺酸氨氯地平分散片|苯磺酸氨氯地平分散片
津力达颗粒|津力达颗粒
恩替卡韦片|恩替卡韦片
复方鳖甲软肝片|复方鳖甲软肝片
安络化纤丸|安络化纤丸
注射用比阿培南|注射用比阿培南
百蕊颗粒|百蕊颗粒
洛索洛芬钠片|洛索洛芬钠片
四妙丸|四妙丸
蛤蚧定喘胶囊|蛤蚧定喘胶囊
注射用呋塞米|注射用呋塞米
急支糖浆|急支糖浆
蜜炼川贝枇杷膏|蜜炼川贝枇杷膏
马来酸依那普利叶酸片|马来酸依那普利叶酸片
硫酸羟氯喹片|硫酸羟氯喹片
皮肤康洗液|皮肤康洗液
糠酸莫米松乳膏|糠酸莫米松乳膏
丹参酮胶囊|丹参酮胶囊
盐酸环丙沙星凝胶|盐酸环丙沙星凝胶
龙珠软膏|龙珠软膏
地奈德乳膏|地奈德乳膏
冰黄肤乐软膏|冰黄肤乐软膏
六神丸|六神丸
莫匹罗星软膏|莫匹罗星软膏
卤米松乳膏|卤米松乳膏
三九胃泰颗粒|三九胃泰颗粒
马应龙麝香痔疮膏|马应龙麝香痔疮膏
地榆槐角丸|地榆槐角丸
补脾益肠丸|补脾益肠丸
胃苏颗粒|胃苏颗粒
复方铝酸铋颗粒|复方铝酸铋颗粒
舒肝止痛丸|舒肝止痛丸
四磨汤口服液|四磨汤口服液
九华痔疮栓|九华痔疮栓
保济口服液|保济口服液
多潘立酮混悬液|多潘立酮混悬液
胃肠安丸|胃肠安丸
坐珠达西|坐珠达西
健胃消炎颗粒|健胃消炎颗粒
左氧氟沙星片|左氧氟沙星片
氟康唑片|氟康唑片
长春西汀片|长春西汀片
丙戊酸钠缓释片|丙戊酸钠缓释片
托吡酯片|托吡酯片
百乐眠胶囊|百乐眠胶囊
脑栓通胶囊|脑栓通胶囊
盐酸阿米替林片|盐酸阿米替林片
盐酸氟西汀片|盐酸氟西汀片
聚乙二醇4000散|聚乙二醇4000散
乌灵胶囊|乌灵胶囊
桂林西瓜霜|桂林西瓜霜
清咽滴丸|清咽滴丸
鼻炎康片|鼻炎康片
鳖甲煎丸|鳖甲煎丸
醋酸地塞米松口腔贴片|醋酸地塞米松口腔贴片
新癀片|新癀片
金喉健喷雾剂|金喉健喷雾剂
玉屏风颗粒|玉屏风颗粒
养血饮口服液|养血饮口服液
复方阿胶浆|复方阿胶浆
孟鲁司特钠咀嚼片|孟鲁司特钠咀嚼片
左归丸|左归丸
大补阴丸|大补阴丸
前列安栓|前列安栓
双石通淋胶囊|双石通淋胶囊
前列平胶囊|前列平胶囊
苁蓉益肾颗粒|苁蓉益肾颗粒
复方双嗪利血平片|复方双嗪利血平片
前列倍喜胶囊|前列倍喜胶囊
黄柏八味片|黄柏八味片
清浊祛毒丸|清浊祛毒丸
盐酸阿扑吗啡舌下片|盐酸阿扑吗啡舌下片
宁泌泰胶囊|宁泌泰胶囊
罗补甫克比日丸|罗补甫克比日丸
爱普列特片|爱普列特片
七味通痹口服液|七味通痹口服液
前列欣胶囊|前列欣胶囊
萘哌地尔分散片|萘哌地尔分散片
非那雄胺分散片|非那雄胺分散片
夏荔芪胶囊|夏荔芪胶囊
尿毒清颗粒|尿毒清颗粒
氟他胺片|氟他胺片
肾安胶囊|肾安胶囊
富马酸替诺福韦二吡呋酯片|富马酸替诺福韦二吡呋酯片
尿清舒颗粒|尿清舒颗粒
排石颗粒|排石颗粒
醋酸钙片|醋酸钙片
阿魏酸哌嗪片|阿魏酸哌嗪片
黄葵胶囊|黄葵胶囊
舒泌通胶囊|舒泌通胶囊
托拉塞米片|托拉塞米片
大株红景天胶囊|大株红景天胶囊
珊瑚七十味丸|珊瑚七十味丸
银丹心泰滴丸|银丹心泰滴丸
盐酸米多君片|盐酸米多君片
盐酸索他洛尔片|盐酸索他洛尔片
肾康栓|肾康栓
门冬氨酸氨氯地平片|门冬氨酸氨氯地平片
活心丸|活心丸
龙生蛭胶囊|龙生蛭胶囊
胞磷胆碱钠片|胞磷胆碱钠片
参仙升脉口服液|参仙升脉口服液
缬沙坦分散片|缬沙坦分散片
心宝丸|心宝丸
丹田降脂丸|丹田降脂丸
二十五味珍珠丸|二十五味珍珠丸
龙心素胶囊|龙心素胶囊
酒石酸美托洛尔控释片|酒石酸美托洛尔控释片
盐酸乐卡地平片|盐酸乐卡地平片
王氏保赤丸|王氏保赤丸
芪龙胶囊|芪龙胶囊
降脂通脉胶囊|降脂通脉胶囊
芪参胶囊|芪参胶囊
华法林钠片|华法林钠片
单硝酸异山梨酯分散片|单硝酸异山梨酯分散片
复方苁蓉益智胶囊|复方苁蓉益智胶囊
苯扎贝特分散片|苯扎贝特分散片
甲磺酸氨氯地平片|甲磺酸氨氯地平片
丹蒌片|丹蒌片
盐酸氟桂利嗪分散片|盐酸氟桂利嗪分散片
延丹胶囊|延丹胶囊
速效心痛滴丸|速效心痛滴丸
匹伐他汀钙片|匹伐他汀钙片
镇脑宁胶囊|镇脑宁胶囊
缬沙坦氢氯噻嗪片|缬沙坦氢氯噻嗪片
尼莫地平缓释片|尼莫地平缓释片
来曲唑片|来曲唑片
二十味沉香丸|二十味沉香丸
麝香通心滴丸|麝香通心滴丸
羟苯磺酸钙分散片|羟苯磺酸钙分散片
复方利血平片|复方利血平片
盐酸胺碘酮片|盐酸胺碘酮片
氨氯地平贝那普利片|氨氯地平贝那普利片
马来酸氨氯地平分散片|马来酸氨氯地平分散片
心脑宁胶囊|心脑宁胶囊
清肝降压胶囊|清肝降压胶囊
脉君安片|脉君安片
阿司匹林肠溶缓释片|阿司匹林肠溶缓释片
理气活血滴丸|理气活血滴丸
硝酸异山梨酯缓释片|硝酸异山梨酯缓释片
米格列醇片|米格列醇片
盐酸吡格列酮分散片|盐酸吡格列酮分散片
格列美脲片|格列美脲片
羟苯磺酸钙片|羟苯磺酸钙片
罗格列酮片|罗格列酮片
格列吡嗪缓释片|格列吡嗪缓释片
酒石酸罗格列酮分散片|酒石酸罗格列酮分散片
格列吡嗪分散片|格列吡嗪分散片
伏格列波糖片|伏格列波糖片
伏格列波糖咀嚼片|伏格列波糖咀嚼片
二甲双胍格列齐特片|二甲双胍格列齐特片
盐酸罗格列酮片|盐酸罗格列酮片
那格列奈分散片|那格列奈分散片
昆仙胶囊|昆仙胶囊
丹鹿通督片|丹鹿通督片
罗浮山风湿膏药|罗浮山风湿膏药
复方夏天无片|复方夏天无片
痹祺胶囊|痹祺胶囊
腰痛宁胶囊|腰痛宁胶囊
肿痛安胶囊|肿痛安胶囊
艾拉莫德片|艾拉莫德片
腰肾膏|腰肾膏
复方雪莲胶囊|复方雪莲胶囊
草乌甲素片|草乌甲素片
骨仙片|骨仙片
仙灵骨葆胶囊|仙灵骨葆胶囊
骨康胶囊|骨康胶囊
消痛贴膏|消痛贴膏
复方杜仲健骨颗粒|复方杜仲健骨颗粒
洛索洛芬钠分散片|洛索洛芬钠分散片
颈复康颗粒|颈复康颗粒
伤科接骨片|伤科接骨片
云南红药胶囊|云南红药胶囊
颈舒颗粒|颈舒颗粒
美洛昔康分散片|美洛昔康分散片
复方金钱草颗粒|复方金钱草颗粒
天和追风膏|天和追风膏
正清风痛宁缓释片|正清风痛宁缓释片
外用应急软膏|外用应急软膏
骨龙胶囊|骨龙胶囊
复方氯唑沙宗分散片|复方氯唑沙宗分散片
盘龙七片|盘龙七片
盐酸替扎尼定片|盐酸替扎尼定片
醋氯芬酸分散片|醋氯芬酸分散片
艾瑞昔布片|艾瑞昔布片
雪山金罗汉止痛涂膜剂|雪山金罗汉止痛涂膜剂
华佗再造丸|华佗再造丸
阿法骨化醇片|阿法骨化醇片
黑骨藤追风活络胶囊|黑骨藤追风活络胶囊
通络祛痛膏|通络祛痛膏
双氯芬酸钠肠溶胶囊|双氯芬酸钠肠溶胶囊
金天格胶囊|金天格胶囊
醋氯芬酸缓释片|醋氯芬酸缓释片
护骨胶囊|护骨胶囊
金乌骨通胶囊|金乌骨通胶囊
万通筋骨片|万通筋骨片
腰痹通胶囊|腰痹通胶囊
通络骨质宁膏|通络骨质宁膏
正骨水|正骨水
骨通贴膏|骨通贴膏
硫酸氨基葡萄糖片|硫酸氨基葡萄糖片
壮骨伸筋胶囊|壮骨伸筋胶囊
跌打万花油|跌打万花油
复方南星止痛膏|复方南星止痛膏
利塞膦酸钠片|利塞膦酸钠片
活血止痛膏|活血止痛膏
颈痛颗粒|颈痛颗粒
治伤胶囊|治伤胶囊
盐酸氨基葡萄糖片|盐酸氨基葡萄糖片
天麻壮骨丸|天麻壮骨丸
镇痛活络酊|镇痛活络酊
伤科灵喷雾剂|伤科灵喷雾剂
风湿祛痛胶囊|风湿祛痛胶囊
代温灸膏|代温灸膏
肾炎康复片|肾炎康复片
消肿止痛酊|消肿止痛酊
骨友灵搽剂|骨友灵搽剂
二十五味驴血丸|二十五味驴血丸
麝香追风膏|麝香追风膏
痛风舒片|痛风舒片
壮骨麝香止痛膏|壮骨麝香止痛膏
别嘌醇片|别嘌醇片
醋酸泼尼松龙片|醋酸泼尼松龙片
通络开痹片|通络开痹片
复方丙酸氯倍他索软膏|复方丙酸氯倍他索软膏
外用紫金锭|外用紫金锭
复方多粘菌素B软膏|复方多粘菌素B软膏
异维A酸红霉素凝胶|异维A酸红霉素凝胶
依巴斯汀片|依巴斯汀片
复方氨肽素片|复方氨肽素片
氢醌乳膏|氢醌乳膏
曲安缩松-尿素乳膏|曲安缩松-尿素乳膏
盐酸左西替利嗪片|盐酸左西替利嗪片
湿润烧伤膏|湿润烧伤膏
复方卡力孜然酊|复方卡力孜然酊
复方曲安奈德乳膏|复方曲安奈德乳膏
枸地氯雷他定片|枸地氯雷他定片
硝呋太尔片|硝呋太尔片
萘替芬酮康唑乳膏|萘替芬酮康唑乳膏
复方鱼肝油氧化锌软膏|复方鱼肝油氧化锌软膏
甲氧沙林溶液|甲氧沙林溶液
盐酸西替利嗪分散片|盐酸西替利嗪分散片
二硫化硒洗剂|二硫化硒洗剂
氯雷他定分散片|氯雷他定分散片
甲硝唑凝胶|甲硝唑凝胶
地氯雷他定分散片|地氯雷他定分散片
倍他米松新霉素乳膏|倍他米松新霉素乳膏
甲氧沙林片|甲氧沙林片
复方磺胺氧化锌软膏|复方磺胺氧化锌软膏
克林霉素磷酸酯外用溶液|克林霉素磷酸酯外用溶液
除湿止痒软膏|除湿止痒软膏
糠酸莫米松乳膏|糠酸莫米松乳膏
消风止痒颗粒|消风止痒颗粒
盐酸阿莫罗芬乳膏|盐酸阿莫罗芬乳膏
氧化锌软膏|氧化锌软膏
红霉素软膏|红霉素软膏
乌蛇止痒丸|乌蛇止痒丸
盐酸多塞平乳膏|盐酸多塞平乳膏
异维A酸凝胶|异维A酸凝胶
醋酸曲安奈德益康唑乳膏|醋酸曲安奈德益康唑乳膏
皮敏消胶囊|皮敏消胶囊
氧化锌升华硫软膏|氧化锌升华硫软膏
复方莪术油栓|复方莪术油栓
鼻窦炎口服液|鼻窦炎口服液
地蒽酚软膏|地蒽酚软膏
荆肤止痒颗粒|荆肤止痒颗粒
复方皂矾丸|复方皂矾丸
他克莫司软膏|他克莫司软膏
盐酸布替萘芬乳膏|盐酸布替萘芬乳膏
丁酸氢化可的松乳膏|丁酸氢化可的松乳膏
槐榆清热止血胶囊|槐榆清热止血胶囊
金龙胶囊|金龙胶囊
马来酸恩替卡韦片|马来酸恩替卡韦片
槐耳颗粒|槐耳颗粒
十味蒂达胶囊|十味蒂达胶囊
肝爽颗粒|肝爽颗粒
复方斑蝥胶囊|复方斑蝥胶囊
壳脂胶囊|壳脂胶囊
六味五灵片|六味五灵片
肝泰舒胶囊|肝泰舒胶囊
胆胃康胶囊|胆胃康胶囊
胆石通胶囊|胆石通胶囊
化滞柔肝颗粒|化滞柔肝颗粒
鲨肝醇片|鲨肝醇片
丁二磺酸腺苷蛋氨酸肠溶片|丁二磺酸腺苷蛋氨酸肠溶片
利胆片|利胆片
平肝舒络丸|平肝舒络丸
熊去氧胆酸片|熊去氧胆酸片
双虎清肝颗粒|双虎清肝颗粒
茵芪肝复颗粒|茵芪肝复颗粒
艾普拉唑肠溶片|艾普拉唑肠溶片
吡喹酮片|吡喹酮片
枳术宽中胶囊|枳术宽中胶囊
达立通颗粒|达立通颗粒
马来酸曲美布汀片|马来酸曲美布汀片
金胃泰胶囊|金胃泰胶囊
马来酸曲美布汀分散片|马来酸曲美布汀分散片
芪蓉润肠口服液|芪蓉润肠口服液
九华膏|九华膏
补肾固齿丸|补肾固齿丸
新复方芦荟胶囊|新复方芦荟胶囊
替加氟片|替加氟片
荆花胃康胶丸|荆花胃康胶丸
痛泻宁颗粒|痛泻宁颗粒
尿嘧啶替加氟片|尿嘧啶替加氟片
康复新液|康复新液
雷贝拉唑钠肠溶片|雷贝拉唑钠肠溶片
生肌散|生肌散
苁蓉通便口服液|苁蓉通便口服液
快胃片|快胃片
保济丸|保济丸
泮托拉唑钠肠溶片|泮托拉唑钠肠溶片
厚朴排气合剂|厚朴排气合剂
复方胃痛胶囊|复方胃痛胶囊
帕朱丸|帕朱丸
西帕依固龈液|西帕依固龈液
安替可胶囊|安替可胶囊
奥美拉唑镁肠溶片|奥美拉唑镁肠溶片
麝香痔疮栓|麝香痔疮栓
降脂通便胶囊|降脂通便胶囊
涩肠止泻散|涩肠止泻散
铝碳酸镁片|铝碳酸镁片
消旋山莨菪碱片|消旋山莨菪碱片
紫地宁血散|紫地宁血散
痔疮栓|痔疮栓
多巴丝肼片|多巴丝肼片
奥氮平片|奥氮平片
草酸艾司西酞普兰片|草酸艾司西酞普兰片
癫痫康胶囊|癫痫康胶囊
通天口服液|通天口服液
拉莫三嗪片|拉莫三嗪片
芪胶升白胶囊|芪胶升白胶囊
马来酸氟伏沙明片|马来酸氟伏沙明片
盐酸舍曲林片|盐酸舍曲林片
痫愈胶囊|痫愈胶囊
桂芍镇痫片|桂芍镇痫片
甲钴胺分散片|甲钴胺分散片
盐酸丁螺环酮片|盐酸丁螺环酮片
癫痫平片|癫痫平片
氢溴酸西酞普兰片|氢溴酸西酞普兰片
盐酸舍曲林分散片|盐酸舍曲林分散片
盐酸帕罗西汀片|盐酸帕罗西汀片
九味镇心颗粒|九味镇心颗粒
左旋多巴片|左旋多巴片
逐瘀通脉胶囊|逐瘀通脉胶囊
盐酸齐拉西酮片|盐酸齐拉西酮片
丹珍头痛胶囊|丹珍头痛胶囊
盐酸米安色林片|盐酸米安色林片
氯氮平片|氯氮平片
碳酸锂片|碳酸锂片
甲钴胺片|甲钴胺片
阿戈美拉汀片|阿戈美拉汀片
碳酸锂缓释片|碳酸锂缓释片
头痛宁胶囊|头痛宁胶囊
盐酸苯海索片|盐酸苯海索片
盐酸地芬尼多片|盐酸地芬尼多片
盐酸多奈哌齐片|盐酸多奈哌齐片
舒必利片|舒必利片
清脑复神液|清脑复神液
加巴喷丁片|加巴喷丁片
盐酸度洛西汀肠溶片|盐酸度洛西汀肠溶片
氯氮平分散片|氯氮平分散片
米氮平片|米氮平片
盐酸氟西汀分散片|盐酸氟西汀分散片
益心巴迪然吉布亚颗粒|益心巴迪然吉布亚颗粒
奋乃静片|奋乃静片
盐酸曲唑酮片|盐酸曲唑酮片
盐酸多奈哌齐分散片|盐酸多奈哌齐分散片
利鲁唑片|利鲁唑片
盐酸司来吉兰片|盐酸司来吉兰片
珍珠通络丸|珍珠通络丸
礞石滚痰片|礞石滚痰片
清肺消炎丸|清肺消炎丸
醋酸氢化可的松片|醋酸氢化可的松片
祛痰止咳颗粒|祛痰止咳颗粒
寒喘祖帕颗粒|寒喘祖帕颗粒
宣肺止嗽合剂|宣肺止嗽合剂
清宣止咳颗粒|清宣止咳颗粒
硫酸沙丁胺醇吸入气雾剂|硫酸沙丁胺醇吸入气雾剂
盐酸班布特罗片|盐酸班布特罗片
孟鲁司特钠片|孟鲁司特钠片
苏黄止咳胶囊|苏黄止咳胶囊
丹葶肺心颗粒|丹葶肺心颗粒
富马酸酮替芬分散片|富马酸酮替芬分散片
盐酸克林霉素棕榈酸酯干混悬剂|盐酸克林霉素棕榈酸酯干混悬剂
玉枢散|玉枢散
三拗片|三拗片
环磷酰胺片|环磷酰胺片
盐酸左氧氟沙星分散片|盐酸左氧氟沙星分散片
益肺清化膏|益肺清化膏
复方红豆杉胶囊|复方红豆杉胶囊
丁细牙痛胶囊|丁细牙痛胶囊
十五味龙胆花丸|十五味龙胆花丸
苓桂咳喘宁胶囊|苓桂咳喘宁胶囊
盐酸赛庚啶片|盐酸赛庚啶片
康莱特软胶囊|康莱特软胶囊
小儿双清颗粒|小儿双清颗粒
硫酸沙丁胺醇气雾剂|硫酸沙丁胺醇气雾剂
紫龙金片|紫龙金片
蛇胆川贝枇杷膏|蛇胆川贝枇杷膏
感咳双清胶囊|感咳双清胶囊
鼻炎片|鼻炎片
参丹散结胶囊|参丹散结胶囊
苏子降气丸|苏子降气丸
急支颗粒|急支颗粒
咳喘顺丸|咳喘顺丸
克淋通胶囊|克淋通胶囊
金振口服液|金振口服液
复方α-酮酸片|复方α-酮酸片
蛤蚧定喘丸|蛤蚧定喘丸
海昆肾喜胶囊|海昆肾喜胶囊
尿石通丸|尿石通丸
布美他尼片|布美他尼片
曲安西龙片|曲安西龙片
复方牙痛酊|复方牙痛酊
肾舒颗粒|肾舒颗粒
醋酸去氨加压素片|醋酸去氨加压素片
卡络磺钠片|卡络磺钠片
坤泰胶囊|坤泰胶囊
复方珍珠口疮颗粒|复方珍珠口疮颗粒
葆宫止血颗粒|葆宫止血颗粒
保妇康栓|保妇康栓
消结安胶囊|消结安胶囊
依西美坦片|依西美坦片
妇科再造丸|妇科再造丸
散结镇痛胶囊|散结镇痛胶囊
消乳散结胶囊|消乳散结胶囊
补血生乳颗粒|补血生乳颗粒
氯喹那多/普罗雌烯阴道片|氯喹那多/普罗雌烯阴道片
盐酸特比萘芬阴道泡腾片|盐酸特比萘芬阴道泡腾片
制霉素片|制霉素片
痛血康胶囊|痛血康胶囊
甲硝唑阴道凝胶|甲硝唑阴道凝胶
抗妇炎胶囊|抗妇炎胶囊
枸橼酸托瑞米芬片|枸橼酸托瑞米芬片
五加生化胶囊|五加生化胶囊
宫瘤消胶囊|宫瘤消胶囊
康妇炎胶囊|康妇炎胶囊
妇炎平胶囊|妇炎平胶囊
苯甲酸雌二醇软膏|苯甲酸雌二醇软膏
复方沙棘籽油栓|复方沙棘籽油栓
化癥回生口服液|化癥回生口服液
阿娜尔妇洁液|阿娜尔妇洁液
荷叶丸|荷叶丸
鲜益母草胶囊|鲜益母草胶囊
康妇凝胶|康妇凝胶
妇炎消胶囊|妇炎消胶囊
裸花紫珠栓|裸花紫珠栓
宫颈炎康栓|宫颈炎康栓
治糜康栓|治糜康栓
痛经宝颗粒|痛经宝颗粒
宫血宁胶囊|宫血宁胶囊
康妇消炎栓|康妇消炎栓
复方黄柏液涂剂|复方黄柏液涂剂
小儿消积止咳口服液|小儿消积止咳口服液
小儿肺咳颗粒|小儿肺咳颗粒
龙牡壮骨颗粒|龙牡壮骨颗粒
健儿清解液|健儿清解液
醒脾养儿颗粒|醒脾养儿颗粒
天黄猴枣散|天黄猴枣散
苍苓止泻口服液|苍苓止泻口服液
小儿肠胃康颗粒|小儿肠胃康颗粒
小儿腹泻散|小儿腹泻散
儿泻康贴膜|儿泻康贴膜
蒙脱石混悬液|蒙脱石混悬液
小儿泻速停颗粒|小儿泻速停颗粒
小儿布洛芬栓|小儿布洛芬栓
小儿热咳口服液|小儿热咳口服液
小儿腹泻贴|小儿腹泻贴
儿泻停颗粒|儿泻停颗粒
双苓止泻口服液|双苓止泻口服液
复方蟾酥膏|复方蟾酥膏
连芩珍珠滴丸|连芩珍珠滴丸
祖卡木颗粒|祖卡木颗粒
小柴胡汤丸|小柴胡汤丸
羟基脲片|羟基脲片
氨糖美辛肠溶片|氨糖美辛肠溶片
复方水杨酸甲酯乳膏|复方水杨酸甲酯乳膏
盐酸乙哌立松片|盐酸乙哌立松片
茜芷胶囊|茜芷胶囊
回生口服液|回生口服液
硫酸氨基葡萄糖钾片|硫酸氨基葡萄糖钾片
阿司匹林维生素C分散片|阿司匹林维生素C分散片
甲磺酸伊马替尼片|甲磺酸伊马替尼片
去氧氟尿苷片|去氧氟尿苷片
对乙酰氨基酚栓|对乙酰氨基酚栓
复方芩兰口服液|复方芩兰口服液
吉非替尼片|吉非替尼片
布洛芬乳膏|布洛芬乳膏
右布洛芬片|右布洛芬片
盐酸埃克替尼片|盐酸埃克替尼片
辛芩颗粒|辛芩颗粒
五味麝香丸|五味麝香丸
鼻渊通窍颗粒|鼻渊通窍颗粒
糠甾醇片|糠甾醇片
咽立爽口含滴丸|咽立爽口含滴丸
祛痰灵口服液|祛痰灵口服液
小儿金翘颗粒|小儿金翘颗粒
口服四维葡萄糖|口服四维葡萄糖
盐酸左氧氟沙星片|盐酸左氧氟沙星片
复方硫酸双肼屈嗪片|复方硫酸双肼屈嗪片
蒲参胶囊|蒲参胶囊
通脉养心丸|通脉养心丸
香砂六君丸|香砂六君丸
三九胃泰胶囊|三九胃泰胶囊
肤痔清软膏|肤痔清软膏
盐酸伊托必利分散片|盐酸伊托必利分散片
吲哚美辛呋喃唑酮栓|吲哚美辛呋喃唑酮栓
醋甲唑胺片|醋甲唑胺片
达沙替尼片|达沙替尼片
厄贝沙坦氢氯噻嗪片|厄贝沙坦氢氯噻嗪片
奥美沙坦酯氢氯噻嗪片|奥美沙坦酯氢氯噻嗪片
脑脉泰胶囊|脑脉泰胶囊
口腔溃疡散|口腔溃疡散
甲硝唑口腔粘贴片|甲硝唑口腔粘贴片
葡萄糖酸氯己定含漱液|葡萄糖酸氯己定含漱液
甲硝唑口颊片|甲硝唑口颊片
清喉咽颗粒|清喉咽颗粒
喜炎平注射液|喜炎平注射液
万应胶囊|万应胶囊
天麻醒脑胶囊|天麻醒脑胶囊
骨痛灵酊|骨痛灵酊
甲泼尼龙片|甲泼尼龙片
复方氯己定含漱液|复方氯己定含漱液
口炎清颗粒|口炎清颗粒
复方珊瑚姜溶液尿素咪康唑软膏复合制剂|复方珊瑚姜溶液尿素咪康唑软膏复合制剂
慈丹胶囊|慈丹胶囊
疤痕止痒软化乳膏|疤痕止痒软化乳膏
盐酸左西替利嗪分散片|盐酸左西替利嗪分散片
威麦宁胶囊|威麦宁胶囊
安康欣胶囊|安康欣胶囊
珍珠明目滴眼液|珍珠明目滴眼液
氟哌啶醇片|氟哌啶醇片
风湿马钱片|风湿马钱片
金蝉止痒胶囊|金蝉止痒胶囊
十味黑冰片丸|十味黑冰片丸
盐酸伐昔洛韦分散片|盐酸伐昔洛韦分散片
风湿二十五味丸|风湿二十五味丸
六味丁香片|六味丁香片
芪珍胶囊|芪珍胶囊
氯雷他定片|氯雷他定片
盾叶冠心宁片|盾叶冠心宁片
克霉唑阴道片|克霉唑阴道片
妇炎平栓|妇炎平栓
甲硝唑氯己定洗剂|甲硝唑氯己定洗剂
浓替硝唑含漱液|浓替硝唑含漱液
氯雷他定泡腾片|氯雷他定泡腾片
小儿清热利肺口服液|小儿清热利肺口服液
醋氯芬酸片|醋氯芬酸片
阿仑膦酸钠肠溶片|阿仑膦酸钠肠溶片
玉叶解毒颗粒|玉叶解毒颗粒
舒心口服液|舒心口服液
氧化锌硫软膏|氧化锌硫软膏
维A酸片|维A酸片
马来酸多潘立酮片|马来酸多潘立酮片
明目蒺藜丸|明目蒺藜丸
地氯雷他定糖浆|地氯雷他定糖浆
骨质宁搽剂|骨质宁搽剂
泛昔洛韦片|泛昔洛韦片
复方硝酸咪康唑软膏|复方硝酸咪康唑软膏
依降钙素注射液|依降钙素注射液
替加氟栓|替加氟栓
抗狼疮散|抗狼疮散
枸橼酸铋钾颗粒|枸橼酸铋钾颗粒
甲硝唑阴道泡腾片|甲硝唑阴道泡腾片
艾附暖宫丸|艾附暖宫丸
盐酸林可霉素滴眼液|盐酸林可霉素滴眼液
辛夷鼻炎丸|辛夷鼻炎丸
硫酸奈替米星氯化钠注射液|硫酸奈替米星氯化钠注射液
氯雷他定糖浆|氯雷他定糖浆
展筋活血散|展筋活血散
可待因桔梗片|可待因桔梗片
醋酸甲地孕酮片|醋酸甲地孕酮片
普济痔疮栓|普济痔疮栓
联磺甲氧苄啶片|联磺甲氧苄啶片
通宣理肺口服液|通宣理肺口服液
九味双解口服液|九味双解口服液
盐酸伊托必利片|盐酸伊托必利片
柴石退热颗粒|柴石退热颗粒
黄氏响声丸|黄氏响声丸
注射用盐酸洛美沙星|注射用盐酸洛美沙星
阿莫西林克拉维酸钾(7:1)片|阿莫西林克拉维酸钾(7:1)片
前列舒通胶囊|前列舒通胶囊
普适泰片|普适泰片
阿昔洛韦凝胶|阿昔洛韦凝胶
阿莫西林舒巴坦匹酯片|阿莫西林舒巴坦匹酯片
重组人干扰素α1b注射液|重组人干扰素α1b注射液
环酯红霉素干混悬剂|环酯红霉素干混悬剂
阿莫西林双氯西林钠片|阿莫西林双氯西林钠片
盐酸洛美沙星片|盐酸洛美沙星片
桂枝颗粒|桂枝颗粒
阿昔洛韦咀嚼片|阿昔洛韦咀嚼片
阿昔洛韦分散片|阿昔洛韦分散片
盐酸多西环素分散片|盐酸多西环素分散片
康力欣胶囊|康力欣胶囊
生血宁片|生血宁片
安多霖胶囊|安多霖胶囊
活力苏口服液|活力苏口服液
雌二醇凝胶|雌二醇凝胶
醋酸甲羟孕酮片|醋酸甲羟孕酮片
小儿生血糖浆|小儿生血糖浆
盐酸左氧氟沙星氯化钠注射液|盐酸左氧氟沙星氯化钠注射液
石榴补血糖浆|石榴补血糖浆
健脾止泻宁颗粒|健脾止泻宁颗粒
强骨胶囊|强骨胶囊
甲磺酸左氧氟沙星片|甲磺酸左氧氟沙星片
来氟米特片|来氟米特片
心元胶囊|心元胶囊
阿莫西林克拉维酸钾咀嚼片|阿莫西林克拉维酸钾咀嚼片
天芪降糖胶囊|天芪降糖胶囊
注射用葡萄糖酸依诺沙星|注射用葡萄糖酸依诺沙星
阿奇霉素葡萄糖注射液|阿奇霉素葡萄糖注射液
石龙清血颗粒|石龙清血颗粒
环丙沙星葡萄糖注射液|环丙沙星葡萄糖注射液
清咳平喘颗粒|清咳平喘颗粒
扫日劳清肺止咳胶囊|扫日劳清肺止咳胶囊
散风活络丸|散风活络丸
曲安奈德注射液|曲安奈德注射液
尼美舒利缓释片|尼美舒利缓释片
二十五味儿茶丸|二十五味儿茶丸
渴络欣胶囊|渴络欣胶囊
唑来膦酸注射液|唑来膦酸注射液
羟乙膦酸钠片|羟乙膦酸钠片
结合雌激素片|结合雌激素片
盐酸雷洛昔芬片|盐酸雷洛昔芬片
右旋布洛芬口服混悬液|右旋布洛芬口服混悬液
益肾蠲痹丸|益肾蠲痹丸
马来酸依那普利口腔崩解片|马来酸依那普利口腔崩解片
脉络宁注射液|脉络宁注射液
丹红注射液|丹红注射液
桂龙咳喘宁颗粒|桂龙咳喘宁颗粒
盐酸罂粟碱注射液|盐酸罂粟碱注射液
壮骨止痛胶囊|壮骨止痛胶囊
替勃龙片|替勃龙片
小儿复方磺胺甲噁唑片|小儿复方磺胺甲噁唑片
盐酸左氧氟沙星注射液|盐酸左氧氟沙星注射液
注射用重组人Ⅱ型肿瘤坏死因子受体-抗体融合蛋白|注射用重组人Ⅱ型肿瘤坏死因子受体-抗体融合蛋白
萘丁美酮分散片|萘丁美酮分散片
罗红霉素氨溴索分散片|罗红霉素氨溴索分散片
痰热清注射液|痰热清注射液
养心达瓦依米西克蜜膏|养心达瓦依米西克蜜膏
注射用盐酸头孢吡肟|注射用盐酸头孢吡肟
地巴唑片|地巴唑片
小儿对乙酰氨基酚片|小儿对乙酰氨基酚片
烯丙雌醇片|烯丙雌醇片
螺内酯片|螺内酯片
加替沙星氯化钠注射液|加替沙星氯化钠注射液
卡贝缩宫素注射液|卡贝缩宫素注射液
普拉洛芬滴眼液|普拉洛芬滴眼液
那他霉素滴眼液|那他霉素滴眼液
环孢素滴眼液|环孢素滴眼液
左氧氟沙星滴眼液|左氧氟沙星滴眼液
消朦眼膏|消朦眼膏
枳实导滞丸|枳实导滞丸
妥布霉素地塞米松滴眼液|妥布霉素地塞米松滴眼液
盐酸左氧氟沙星滴眼液|盐酸左氧氟沙星滴眼液
吲哚美辛滴眼液|吲哚美辛滴眼液
诺氟沙星滴眼液|诺氟沙星滴眼液
复方氢氧化铝镁片|复方氢氧化铝镁片
泮托拉唑钠肠溶胶囊|泮托拉唑钠肠溶胶囊
苯酰甲硝唑分散片|苯酰甲硝唑分散片
罗红霉素分散片|罗红霉素分散片
奋乃静注射液|奋乃静注射液
创灼膏|创灼膏
癸氟奋乃静注射液|癸氟奋乃静注射液
肠胃舒胶囊|肠胃舒胶囊
当归苦参丸|当归苦参丸
肠炎宁颗粒|肠炎宁颗粒
盐酸环丙沙星软膏|盐酸环丙沙星软膏
止血镇痛胶囊|止血镇痛胶囊
巴特日七味丸|巴特日七味丸
女珍颗粒|女珍颗粒
双歧杆菌乳杆菌三联活菌片|双歧杆菌乳杆菌三联活菌片
阿莫西林克拉维酸钾(2:1)咀嚼片|阿莫西林克拉维酸钾(2:1)咀嚼片
抗骨髓炎片|抗骨髓炎片
聚苯乙烯磺酸钙散|聚苯乙烯磺酸钙散
盐酸西替利嗪片|盐酸西替利嗪片
小儿盐酸异丙嗪片|小儿盐酸异丙嗪片
小儿定喘口服液|小儿定喘口服液
止喘灵口服液|止喘灵口服液
枸橼酸铋钾咀嚼片|枸橼酸铋钾咀嚼片
注射用盐酸伊达比星|注射用盐酸伊达比星
硝呋太尔阴道片|硝呋太尔阴道片
小儿肺热清颗粒|小儿肺热清颗粒
苯扎贝特片|苯扎贝特片
十一酸睾酮注射液|十一酸睾酮注射液
法罗培南钠片|法罗培南钠片
妇阴康洗剂|妇阴康洗剂
叶酸片|叶酸片
解毒活血栓|解毒活血栓
阿昔洛韦葡萄糖注射液|阿昔洛韦葡萄糖注射液
注射用异环磷酰胺|注射用异环磷酰胺
天王补心丹|天王补心丹
疏血通注射液|疏血通注射液
乙酰天麻素片|乙酰天麻素片
利福喷丁分散片|利福喷丁分散片
注射用前列地尔干乳剂|注射用前列地尔干乳剂
木香槟榔丸|木香槟榔丸
六味香连胶囊|六味香连胶囊
异烟肼氯化钠注射液|异烟肼氯化钠注射液
阿昔洛韦片|阿昔洛韦片
双黄连滴眼剂|双黄连滴眼剂
琥乙红霉素咀嚼片|琥乙红霉素咀嚼片
仁青常觉|仁青常觉
谷胱甘肽片|谷胱甘肽片
复方卡比多巴片|复方卡比多巴片
氟康唑颗粒|氟康唑颗粒
注射用阿昔洛韦|注射用阿昔洛韦
阿昔洛韦氯化钠注射液|阿昔洛韦氯化钠注射液
注射用青霉素钾|注射用青霉素钾
速效牙痛宁酊|速效牙痛宁酊
氟康唑氯化钠注射液|氟康唑氯化钠注射液
复方四环素片|复方四环素片
糠酸莫米松鼻喷雾剂|糠酸莫米松鼻喷雾剂
复方新霉素软膏|复方新霉素软膏
尿素软膏|尿素软膏
季德胜蛇药片|季德胜蛇药片
氟轻松维B6乳膏|氟轻松维B6乳膏
复方水杨酸樟碘溶液Ⅰ|复方水杨酸樟碘溶液Ⅰ
复方醋酸氯己定喷剂|复方醋酸氯己定喷剂
氧化锌油|氧化锌油
癣湿药水|癣湿药水
六神胶囊|六神胶囊
卡莫司汀注射液|卡莫司汀注射液
注射用福莫司汀|注射用福莫司汀
炎消迪娜儿糖浆|炎消迪娜儿糖浆
康艾注射液|康艾注射液
注射用甲氨蝶呤|注射用甲氨蝶呤
乌梅丸|乌梅丸
艾迪注射液|艾迪注射液
沙利度胺片|沙利度胺片
硼酸氧化锌冰片软膏|硼酸氧化锌冰片软膏
葛根素氯化钠注射液|葛根素氯化钠注射液
醋酸氯己定溶液|醋酸氯己定溶液
复方十一烯酸锌曲安奈德软膏|复方十一烯酸锌曲安奈德软膏
复方水杨酸冰片软膏|复方水杨酸冰片软膏
曲安奈德益康唑乳膏|曲安奈德益康唑乳膏
甲硫酸新斯的明注射液|甲硫酸新斯的明注射液
氟尿嘧啶乳膏|氟尿嘧啶乳膏
注射用七叶皂苷钠|注射用七叶皂苷钠
注射用盐酸平阳霉素|注射用盐酸平阳霉素
鱼鳞病片|鱼鳞病片
克霉唑倍他米松乳膏|克霉唑倍他米松乳膏
丙酸倍氯米松软膏|丙酸倍氯米松软膏
丙酸倍氯米松乳膏|丙酸倍氯米松乳膏
色甘酸钠气雾剂|色甘酸钠气雾剂
注射用普罗碘铵|注射用普罗碘铵
普罗碘铵注射液|普罗碘铵注射液
氟罗沙星葡萄糖注射液|氟罗沙星葡萄糖注射液
吡拉西坦葡萄糖注射液|吡拉西坦葡萄糖注射液
双丹明目胶囊|双丹明目胶囊
甘露消毒丸|甘露消毒丸
甘油果糖氯化钠注射液|甘油果糖氯化钠注射液
己酮可可碱葡萄糖注射液|己酮可可碱葡萄糖注射液
盐酸克林霉素棕榈酸酯颗粒|盐酸克林霉素棕榈酸酯颗粒
维生素A棕榈酸酯眼用凝胶|维生素A棕榈酸酯眼用凝胶
马来酸右噻吗洛尔滴眼液|马来酸右噻吗洛尔滴眼液
丹红化瘀口服液|丹红化瘀口服液
小儿消积止咳颗粒|小儿消积止咳颗粒
硫酸庆大霉素氟米龙滴眼液|硫酸庆大霉素氟米龙滴眼液
粘膜溃疡散|粘膜溃疡散
硫酸阿托品眼用凝胶|硫酸阿托品眼用凝胶
金叶败毒颗粒|金叶败毒颗粒
清开灵软胶囊|清开灵软胶囊
参附注射液|参附注射液
前列舒丸|前列舒丸
生肌玉红膏|生肌玉红膏
肾康注射液|肾康注射液
茶苯海明含片|茶苯海明含片
泰脂安胶囊|泰脂安胶囊
关节止痛膏|关节止痛膏
灯盏花素氯化钠注射液|灯盏花素氯化钠注射液
注射用磷酸依托泊苷|注射用磷酸依托泊苷
注射用环磷酰胺|注射用环磷酰胺
萘哌地尔片|萘哌地尔片
注射用美洛西林钠舒巴坦钠|注射用美洛西林钠舒巴坦钠
注射用硫酸阿奇霉素|注射用硫酸阿奇霉素
盐酸克林霉素葡萄糖注射液|盐酸克林霉素葡萄糖注射液
注射用盐酸大观霉素|注射用盐酸大观霉素
盐酸克林霉素氯化钠注射液|盐酸克林霉素氯化钠注射液
氧氟沙星葡萄糖注射液|氧氟沙星葡萄糖注射液
注射用盐酸左氧氟沙星|注射用盐酸左氧氟沙星
阿莫西林克拉维酸钾分散片|阿莫西林克拉维酸钾分散片
注射用拉氧头孢钠|注射用拉氧头孢钠
氨苄西林丙磺舒口腔崩解片|氨苄西林丙磺舒口腔崩解片
磺胺嘧啶片|磺胺嘧啶片
盐酸四环素片|盐酸四环素片
四环素片|四环素片
左氧氟沙星注射液|左氧氟沙星注射液
泌宁胶囊|泌宁胶囊
盐酸加替沙星氯化钠注射液|盐酸加替沙星氯化钠注射液
阿莫西林分散片|阿莫西林分散片
血平片|血平片
门冬氨酸洛美沙星氯化钠注射液|门冬氨酸洛美沙星氯化钠注射液
诺氟沙星片|诺氟沙星片
硫酸依替米星注射液|硫酸依替米星注射液
硫酸异帕米星注射液|硫酸异帕米星注射液
注射用头孢米诺钠|注射用头孢米诺钠
注射用头孢美唑钠|注射用头孢美唑钠
甲磺酸帕珠沙星氯化钠注射液|甲磺酸帕珠沙星氯化钠注射液
野菊花栓|野菊花栓
复方酚苄明片|复方酚苄明片
乌鸡白凤颗粒|乌鸡白凤颗粒
大黄三味片|大黄三味片
苯甲酸雌二醇注射液|苯甲酸雌二醇注射液
产复康颗粒|产复康颗粒
炔雌醇环丙孕酮片|炔雌醇环丙孕酮片
替硝唑阴道片|替硝唑阴道片
替硝唑阴道泡腾片|替硝唑阴道泡腾片
合成鱼腥草素片|合成鱼腥草素片
双氯芬酸钾片|双氯芬酸钾片
外用溃疡散|外用溃疡散
滋肾育胎丸|滋肾育胎丸
缩宫素鼻喷雾剂|缩宫素鼻喷雾剂
卡前列素氨丁三醇注射液|卡前列素氨丁三醇注射液
安宫止血颗粒|安宫止血颗粒
杜仲颗粒|杜仲颗粒
注射用氨甲环酸|注射用氨甲环酸
甲硝唑维B6片|甲硝唑维B6片
替硝唑片|替硝唑片
克霉唑尿素乳膏|克霉唑尿素乳膏
硝酸益康唑乳膏|硝酸益康唑乳膏
甲紫溶液|甲紫溶液
环吡酮胺乳膏|环吡酮胺乳膏
酮康唑乳膏|酮康唑乳膏
注射用盐酸阿奇霉素|注射用盐酸阿奇霉素
注射用门冬氨酸阿奇霉素|注射用门冬氨酸阿奇霉素
阿奇霉素注射液|阿奇霉素注射液
注射用阿奇霉素|注射用阿奇霉素
利福霉素钠注射液|利福霉素钠注射液
氨酚双氢可待因片|氨酚双氢可待因片
尼美舒利片|尼美舒利片
精氨酸阿司匹林片|精氨酸阿司匹林片
对乙酰氨基酚维生素C泡腾片|对乙酰氨基酚维生素C泡腾片
复方阿司匹林双层片|复方阿司匹林双层片
元胡止痛口服液|元胡止痛口服液
吲哚美辛沙丁胺醇栓|吲哚美辛沙丁胺醇栓
复方益母口服液|复方益母口服液
阿司匹林维C肠溶片|阿司匹林维C肠溶片
布洛芬口腔崩解片|布洛芬口腔崩解片
尼美舒利分散片|尼美舒利分散片
布洛芬口崩片|布洛芬口崩片
布洛芬片|布洛芬片
奥硝唑葡萄糖注射液|奥硝唑葡萄糖注射液
盐酸环丙沙星阴道泡腾片|盐酸环丙沙星阴道泡腾片
复方克霉唑乳膏|复方克霉唑乳膏
硝酸咪康唑乳膏|硝酸咪康唑乳膏
氧氟沙星阴道泡腾片|氧氟沙星阴道泡腾片
硫酸庆大霉素氯化钠注射液|硫酸庆大霉素氯化钠注射液
替硝唑含片|替硝唑含片
制霉素阴道泡腾片|制霉素阴道泡腾片
注射用硫酸镁|注射用硫酸镁
维生素D3注射液|维生素D3注射液
维生素D2片|维生素D2片
骨折挫伤胶囊|骨折挫伤胶囊
氯膦酸二钠注射液|氯膦酸二钠注射液
烫疮油|烫疮油
胆维丁乳|胆维丁乳
亚叶酸钙氯化钠注射液|亚叶酸钙氯化钠注射液
注射用维生素C|注射用维生素C
磺胺嘧啶银乳膏|磺胺嘧啶银乳膏
琥珀酸亚铁缓释片|琥珀酸亚铁缓释片
硫酸亚铁缓释片|硫酸亚铁缓释片
维生素C咀嚼片|维生素C咀嚼片
维生素C泡腾片|维生素C泡腾片
复方维生素B2片|复方维生素B2片
维生素B2片|维生素B2片
维生素C注射液|维生素C注射液
注射用维生素B6|注射用维生素B6
复合维生素BC片|复合维生素BC片
注射用硝普钠|注射用硝普钠
盐酸利多卡因注射液|盐酸利多卡因注射液
酒石酸美托洛尔注射液|酒石酸美托洛尔注射液
醋酸甲萘氢醌片|醋酸甲萘氢醌片
地高辛注射液|地高辛注射液
奥美拉唑钠肠溶片|奥美拉唑钠肠溶片
盐酸倍他司汀注射液|盐酸倍他司汀注射液
盐酸雷尼替丁片|盐酸雷尼替丁片
奥美拉唑肠溶片|奥美拉唑肠溶片
天麻素注射液|天麻素注射液
烟酰胺葡萄糖注射液|烟酰胺葡萄糖注射液
烟酰胺注射液|烟酰胺注射液
马来酸依那普利片|马来酸依那普利片
苯妥英钠片|苯妥英钠片
硝酸异山梨脂葡萄糖注射液|硝酸异山梨脂葡萄糖注射液
马来酸左旋氨氯地平分散片|马来酸左旋氨氯地平分散片
葛根素葡萄糖注射液|葛根素葡萄糖注射液
注射用葛根素|注射用葛根素
硝酸异山梨酯注射液|硝酸异山梨酯注射液
辅酶Q10氯化钠注射液|辅酶Q10氯化钠注射液
托拉塞米注射液|托拉塞米注射液
布美他尼注射液|布美他尼注射液
呋塞米片|呋塞米片
硝酸甘油注射液|硝酸甘油注射液
注射用托拉塞米|注射用托拉塞米
曲克芦丁脑蛋白水解物注射液|曲克芦丁脑蛋白水解物注射液
前列地尔注射液|前列地尔注射液
盐酸拉贝洛尔片|盐酸拉贝洛尔片
注射用左卡尼汀|注射用左卡尼汀
丹参酮ⅡA磺酸钠注射液|丹参酮ⅡA磺酸钠注射液
注射用二丁酰环磷腺苷钙|注射用二丁酰环磷腺苷钙
阿替洛尔片|阿替洛尔片
环磷腺苷氯化钠注射液|环磷腺苷氯化钠注射液
辛伐他汀片|辛伐他汀片
环磷腺苷注射液|环磷腺苷注射液
注射用酒石酸美托洛尔|注射用酒石酸美托洛尔
乳酸左氧氟沙星分散片|乳酸左氧氟沙星分散片
金黄利胆胶囊|金黄利胆胶囊
荜铃胃痛颗粒|荜铃胃痛颗粒
寒水石二十一味散|寒水石二十一味散
延参健胃胶囊|延参健胃胶囊
复方陈香胃片|复方陈香胃片
铋镁碳酸氢钠片|铋镁碳酸氢钠片
法莫替丁分散片|法莫替丁分散片
益气和胃胶囊|益气和胃胶囊
胃疼宁片|胃疼宁片
醋酸甲地孕酮分散片|醋酸甲地孕酮分散片
热毒宁注射液|热毒宁注射液
阿司匹林咀嚼片|阿司匹林咀嚼片
复方倍他米松注射液|复方倍他米松注射液
盐酸左氧氟沙星滴耳液|盐酸左氧氟沙星滴耳液
血脂平胶囊|血脂平胶囊
氯雷他定伪麻黄碱缓释片|氯雷他定伪麻黄碱缓释片
小儿清热感冒片|小儿清热感冒片
富马酸酮替芬鼻喷雾剂|富马酸酮替芬鼻喷雾剂
跌打片|跌打片
消癌平注射液|消癌平注射液
青霉胺片|青霉胺片
小儿导赤片|小儿导赤片
穿心莲丸|穿心莲丸
舒肝宁注射液|舒肝宁注射液
瓜霜退热灵胶囊|瓜霜退热灵胶囊
替硝唑口腔贴片|替硝唑口腔贴片
硫辛酸注射液|硫辛酸注射液
氨磺必利片|氨磺必利片
盐酸酚苄明片|盐酸酚苄明片
小儿石蔻散|小儿石蔻散
消炎止痛膏|消炎止痛膏
注射用氯诺昔康|注射用氯诺昔康
牛黄清感胶囊|牛黄清感胶囊
小儿宝泰康颗粒|小儿宝泰康颗粒
双料喉风散|双料喉风散
银蒲解毒片|银蒲解毒片
川蛭通络胶囊|川蛭通络胶囊
脑脉利颗粒|脑脉利颗粒
灯银脑通胶囊|灯银脑通胶囊
丹膝颗粒|丹膝颗粒
化风丹|化风丹
辛芩片|辛芩片
盐酸奥洛他定片|盐酸奥洛他定片
乙酰唑胺片|乙酰唑胺片
养正合剂|养正合剂
丙硫氧嘧啶片|丙硫氧嘧啶片
消渴清颗粒|消渴清颗粒
喷托维林氯化铵片|喷托维林氯化铵片
清音丸|清音丸
补肺活血胶囊|补肺活血胶囊
磷酸可待因缓释片|磷酸可待因缓释片
亚叶酸钙片|亚叶酸钙片
洛伐他汀分散片|洛伐他汀分散片
加味天麻胶囊|加味天麻胶囊
注射用奈达铂|注射用奈达铂
阿那曲唑片|阿那曲唑片
克霉唑乳膏|克霉唑乳膏
枸橼酸氯米芬片|枸橼酸氯米芬片
盐酸普萘洛尔缓释片|盐酸普萘洛尔缓释片
盐酸哌唑嗪片|盐酸哌唑嗪片
替米沙坦氢氯噻嗪片|替米沙坦氢氯噻嗪片
鞣酸加压素注射液|鞣酸加压素注射液
利血平片|利血平片
盐酸维拉帕米缓释片|盐酸维拉帕米缓释片
盐酸雷尼替丁注射液|盐酸雷尼替丁注射液
盐酸特比萘芬片|盐酸特比萘芬片
妇科断红饮胶囊|妇科断红饮胶囊
健心合米尔高滋斑安比热片|健心合米尔高滋斑安比热片
低精蛋白锌胰岛素注射液|低精蛋白锌胰岛素注射液
参芪扶正注射液|参芪扶正注射液
醋酸地塞米松片|醋酸地塞米松片
甲硝唑缓释片|甲硝唑缓释片
华蟾素注射液|华蟾素注射液
注射用重组人粒细胞巨噬细胞刺激因子|注射用重组人粒细胞巨噬细胞刺激因子
氟尿嘧啶葡萄糖注射液|氟尿嘧啶葡萄糖注射液
马应龙八宝眼膏|马应龙八宝眼膏
红花黄色素氯化钠注射液|红花黄色素氯化钠注射液
丹香清脂颗粒|丹香清脂颗粒
盐酸罗哌卡因氯化钠注射液|盐酸罗哌卡因氯化钠注射液
胃力康颗粒|胃力康颗粒
注射用盐酸吡柔比星|注射用盐酸吡柔比星
克霉唑阴道泡腾片|克霉唑阴道泡腾片
活血舒筋酊|活血舒筋酊
康莱特注射液|康莱特注射液
金复康口服液|金复康口服液
润肺膏|润肺膏
哮喘丸|哮喘丸
参芎葡萄糖注射液|参芎葡萄糖注射液
大柴胡颗粒|大柴胡颗粒
通窍耳聋丸|通窍耳聋丸
艾愈胶囊|艾愈胶囊
护肝丸|护肝丸
卡铂注射液|卡铂注射液
醋酸氢化可的松乳膏|醋酸氢化可的松乳膏
注射用齐多夫定|注射用齐多夫定
复方磺胺嘧啶锌凝胶|复方磺胺嘧啶锌凝胶
倍他米松磷酸钠注射液|倍他米松磷酸钠注射液
盐酸氯普鲁卡因注射液|盐酸氯普鲁卡因注射液
醋酸地塞米松乳膏|醋酸地塞米松乳膏
注射用阿糖腺苷|注射用阿糖腺苷
诺氟沙星软膏|诺氟沙星软膏
解毒烧伤软膏|解毒烧伤软膏
磺胺嘧啶银软膏|磺胺嘧啶银软膏
葡萄糖酸钙颗粒|葡萄糖酸钙颗粒
注射用盐酸二甲弗林|注射用盐酸二甲弗林
蒿甲醚片|蒿甲醚片
注射用舒巴坦钠|注射用舒巴坦钠
泻停胶囊|泻停胶囊
救心丸|救心丸
豨红通络口服液|豨红通络口服液
参桂胶囊|参桂胶囊
青蒿素哌喹片|青蒿素哌喹片
注射用甘草酸二铵|注射用甘草酸二铵
硫酸阿米卡星注射液|硫酸阿米卡星注射液
盐酸丁卡因胶浆|盐酸丁卡因胶浆
七叶神安片|七叶神安片
血滞通胶囊|血滞通胶囊
包醛氧淀粉|包醛氧淀粉
补心气口服液|补心气口服液
葛酮通络胶囊|葛酮通络胶囊
富马酸比索洛尔片|富马酸比索洛尔片
赖诺普利片|赖诺普利片
天麦消渴片|天麦消渴片
瑞格列奈片|瑞格列奈片
吡格列酮二甲双胍片|吡格列酮二甲双胍片
盐酸二甲双胍片|盐酸二甲双胍片
盐酸吡格列酮片|盐酸吡格列酮片
盐酸二甲双胍缓释片|盐酸二甲双胍缓释片
治伤软膏|治伤软膏
麝香追风止痛膏|麝香追风止痛膏
解毒生肌膏|解毒生肌膏
复方土槿皮酊|复方土槿皮酊
平眩胶囊|平眩胶囊
复方木尼孜其颗粒|复方木尼孜其颗粒
盐酸纳美芬注射液|盐酸纳美芬注射液
复方聚乙二醇电解质散|复方聚乙二醇电解质散
黄厚止泻滴丸|黄厚止泻滴丸
苯巴比妥东莨菪碱片|苯巴比妥东莨菪碱片
米格列奈钙片|米格列奈钙片
复方伤痛胶囊|复方伤痛胶囊
安坤颗粒|安坤颗粒
滇白珠糖浆|滇白珠糖浆
苯磺酸左旋氨氯地平片|苯磺酸左旋氨氯地平片
盐酸奥洛他定滴眼液|盐酸奥洛他定滴眼液
五黄膏|五黄膏
地红霉素肠溶片|地红霉素肠溶片
六神凝胶|六神凝胶
苯溴马隆片|苯溴马隆片
愈心痛胶囊|愈心痛胶囊
注射用头孢哌酮钠舒巴坦钠|注射用头孢哌酮钠舒巴坦钠
雪胆素片|雪胆素片
二妙丸|二妙丸
复方苯巴比妥溴化钠片|复方苯巴比妥溴化钠片
肉蔻五味丸|肉蔻五味丸
呋喃妥因片|呋喃妥因片
门冬氨酸洛美沙星注射液|门冬氨酸洛美沙星注射液
硫酸庆大霉素注射液|硫酸庆大霉素注射液
硝酸益康唑栓；硝酸益康唑阴道膨胀栓|硝酸益康唑栓；硝酸益康唑阴道膨胀栓
肿痛气雾剂|肿痛气雾剂
地氯雷他定片|地氯雷他定片
秋水仙碱片|秋水仙碱片
硫酸氨基葡萄糖泡腾片|硫酸氨基葡萄糖泡腾片
萘丁美酮片|萘丁美酮片
富马酸喹硫平片|富马酸喹硫平片
盐酸多塞平片|盐酸多塞平片
氟哌噻吨美利曲辛片|氟哌噻吨美利曲辛片
维生素B6注射液|维生素B6注射液
丹栀逍遥丸|丹栀逍遥丸
阿莫西林舒巴坦匹酯咀嚼片|阿莫西林舒巴坦匹酯咀嚼片
氧氟沙星滴耳液|氧氟沙星滴耳液
别嘌醇缓释片|别嘌醇缓释片
注射用氨苄西林钠氯唑西林钠|注射用氨苄西林钠氯唑西林钠
苦黄注射液|苦黄注射液
鸦胆子油乳注射液|鸦胆子油乳注射液
多潘立酮口腔崩解片|多潘立酮口腔崩解片
氢溴酸加兰他敏注射液|氢溴酸加兰他敏注射液
地奥司明片|地奥司明片
精氨酸布洛芬片|精氨酸布洛芬片
氧氟沙星甘露醇注射液|氧氟沙星甘露醇注射液
注射用左氧氟沙星|注射用左氧氟沙星
匹维溴铵片|匹维溴铵片
灵泽片|灵泽片
萆薢分清丸|萆薢分清丸
吡哌酸片|吡哌酸片
注射用哌拉西林钠|注射用哌拉西林钠
乳癖消丸|乳癖消丸
阿莫西林/克拉维酸钾片|阿莫西林/克拉维酸钾片
氟康唑滴眼液|氟康唑滴眼液
宝儿康散|宝儿康散
银盏心脉滴丸|银盏心脉滴丸
金花明目丸|金花明目丸
贝那普利氢氯噻嗪片|贝那普利氢氯噻嗪片
乳酸左氧氟沙星氯化钠注射液|乳酸左氧氟沙星氯化钠注射液
固肾定喘丸|固肾定喘丸
心灵丸|心灵丸
丹参益心胶囊|丹参益心胶囊
麝香海马追风膏|麝香海马追风膏
风湿液|风湿液
如意珍宝丸|如意珍宝丸
复方四嗪利血平片|复方四嗪利血平片
表虚感冒颗粒|表虚感冒颗粒
天智颗粒|天智颗粒
西尼地平片|西尼地平片
盐酸氟桂利嗪片|盐酸氟桂利嗪片
阿魏酸哌嗪分散片|阿魏酸哌嗪分散片
维生素C|维生素C
阿司匹林双嘧达莫片|阿司匹林双嘧达莫片
益心宁神片|益心宁神片
复方利血平氢氯噻嗪片|复方利血平氢氯噻嗪片
瑞格列奈分散片|瑞格列奈分散片
珍宝丸|珍宝丸
祖师麻注射液|祖师麻注射液
石椒草咳喘颗粒|石椒草咳喘颗粒
锡类散|锡类散
吡拉西坦注射液|吡拉西坦注射液
大蒜素软胶囊|大蒜素软胶囊
硫酸庆大霉素滴眼液|硫酸庆大霉素滴眼液
尿感宁颗粒|尿感宁颗粒
醋酸曲安奈德尿素软膏|醋酸曲安奈德尿素软膏
正清风痛宁注射液|正清风痛宁注射液
盐酸洛哌丁胺颗粒|盐酸洛哌丁胺颗粒
富马酸酮替芬滴眼液|富马酸酮替芬滴眼液
多索茶碱片|多索茶碱片
阿托伐他汀钙分散片|阿托伐他汀钙分散片
氧氟沙星氯化钠注射液|氧氟沙星氯化钠注射液
注射用双氯芬酸钠盐酸利多卡因|注射用双氯芬酸钠盐酸利多卡因
注射用盐酸硫必利|注射用盐酸硫必利
盐酸硫必利注射液|盐酸硫必利注射液
噻奈普汀钠片|噻奈普汀钠片
盐酸氟奋乃静片|盐酸氟奋乃静片
盐酸三氟拉嗪片|盐酸三氟拉嗪片
甲磺酸齐拉西酮注射液|甲磺酸齐拉西酮注射液
五氟利多片|五氟利多片
氢溴酸加兰他敏口腔崩解片|氢溴酸加兰他敏口腔崩解片
卡比多巴片|卡比多巴片
佐匹克隆片|佐匹克隆片
酒石酸唑吡坦口腔崩解片|酒石酸唑吡坦口腔崩解片
膦甲酸钠氯化钠注射液|膦甲酸钠氯化钠注射液
那如三味丸|那如三味丸
复方甲苯咪唑片|复方甲苯咪唑片
苯唑西林钠片|苯唑西林钠片
阿昔洛韦注射液|阿昔洛韦注射液
甲地高辛片|甲地高辛片
复方对乙酰氨基酚片|复方对乙酰氨基酚片
地氯雷他定干混悬剂|地氯雷他定干混悬剂
乙酰螺旋霉素片|乙酰螺旋霉素片
肝素钠维E乳膏|肝素钠维E乳膏
柴胡舒肝丸|柴胡舒肝丸
葡萄糖酸锑钠注射液|葡萄糖酸锑钠注射液
复方阿苯达唑片|复方阿苯达唑片
阿苯达唑咀嚼片|阿苯达唑咀嚼片
扑米酮片|扑米酮片
注射用盐酸头孢替安|注射用盐酸头孢替安
氯喹那多-普罗雌烯阴道片|氯喹那多-普罗雌烯阴道片
双氯芬酸钠滴眼液|双氯芬酸钠滴眼液
磷酸伯氨喹片|磷酸伯氨喹片
注射用伏立康唑|注射用伏立康唑
林旦乳膏|林旦乳膏
尼尔雌醇片|尼尔雌醇片
氟康唑葡萄糖注射液|氟康唑葡萄糖注射液
注射用盐酸多西环素|注射用盐酸多西环素
喘可治注射液|喘可治注射液
硫酸新霉素软膏|硫酸新霉素软膏
阿拉坦五味丸|阿拉坦五味丸
斑秃丸|斑秃丸
注射用硫酸链霉素|注射用硫酸链霉素
环酯红霉素片|环酯红霉素片
环孢素注射液|环孢素注射液
榄香烯注射液|榄香烯注射液
吉祥安坤丸|吉祥安坤丸
肤痒颗粒|肤痒颗粒
依地酸钙钠注射液|依地酸钙钠注射液
黑豆馏油软膏|黑豆馏油软膏
注射用乳酸左氧氟沙星|注射用乳酸左氧氟沙星
氨苯砜片|氨苯砜片
左奥硝唑氯化钠注射液|左奥硝唑氯化钠注射液
四逆汤|四逆汤
醋酸曲安西龙尿素乳膏|醋酸曲安西龙尿素乳膏
千金止带丸|千金止带丸
复方水杨酸搽剂|复方水杨酸搽剂
罗红霉素片|罗红霉素片
鱼肝油酸钠注射液|鱼肝油酸钠注射液
注射用胰激肽原酶|注射用胰激肽原酶
胰激肽原酶肠溶片|胰激肽原酶肠溶片
盐酸环丙沙星滴耳液|盐酸环丙沙星滴耳液
盐酸林可霉素滴耳液|盐酸林可霉素滴耳液
己酮可可碱氯化钠注射液|己酮可可碱氯化钠注射液
注射用普鲁卡因青霉素|注射用普鲁卡因青霉素
盐酸左氧氟沙星葡萄糖注射液|盐酸左氧氟沙星葡萄糖注射液
硫酸沙丁胺醇粉雾剂|硫酸沙丁胺醇粉雾剂
注射用糜蛋白酶|注射用糜蛋白酶
小儿咽扁颗粒|小儿咽扁颗粒
磺胺醋酰钠滴眼液|磺胺醋酰钠滴眼液
氟罗沙星注射液|氟罗沙星注射液
布洛芬缓释片|布洛芬缓释片
亚叶酸钙注射液|亚叶酸钙注射液
定坤丹|定坤丹
甲磺酸倍他司汀片|甲磺酸倍他司汀片
茶碱葡萄糖注射液|茶碱葡萄糖注射液
芍杞颗粒|芍杞颗粒
维生素B12注射液|维生素B12注射液
溴新斯的明片|溴新斯的明片
注射用门冬氨酸鸟氨酸|注射用门冬氨酸鸟氨酸
双氯芬酸钠缓释片|双氯芬酸钠缓释片
过氧化氢溶液|过氧化氢溶液
天菊脑安胶囊|天菊脑安胶囊
硫唑嘌呤片|硫唑嘌呤片
硫酸链霉素注射液|硫酸链霉素注射液
黛蛤散|黛蛤散
牛黄醒消丸|牛黄醒消丸
呋喃唑酮片|呋喃唑酮片
地贞颗粒|地贞颗粒
祖师麻片|祖师麻片
苏合香丸|苏合香丸
吲哚美辛栓|吲哚美辛栓
注射用丹参多酚酸盐|注射用丹参多酚酸盐
己酮可可碱注射液|己酮可可碱注射液
中满分消丸|中满分消丸
氧氟沙星片|氧氟沙星片
注射用甲磺酸左氧氟沙星|注射用甲磺酸左氧氟沙星
非那雄胺片|非那雄胺片
盐酸特拉唑嗪片|盐酸特拉唑嗪片
葡萄糖酸依诺沙星注射液|葡萄糖酸依诺沙星注射液
硫酸阿奇霉素注射液|硫酸阿奇霉素注射液
阿奇霉素糖浆|阿奇霉素糖浆
克林霉素磷酸酯氯化钠注射液|克林霉素磷酸酯氯化钠注射液
乳酸左氧氟沙星葡萄糖注射液|乳酸左氧氟沙星葡萄糖注射液
乳酸左氧氟沙星注射液|乳酸左氧氟沙星注射液
乳酸环丙沙星氯化钠注射液|乳酸环丙沙星氯化钠注射液
乳酸左氧氟沙星片|乳酸左氧氟沙星片
乳酸环丙沙星注射液|乳酸环丙沙星注射液
氧氟沙星注射液|氧氟沙星注射液
盐酸环丙沙星片|盐酸环丙沙星片
注射用氧氟沙星|注射用氧氟沙星
阿莫西林克拉维酸钾片|阿莫西林克拉维酸钾片
注射用乳酸环丙沙星|注射用乳酸环丙沙星
注射用头孢他啶|注射用头孢他啶
注射用亚胺培南西司他丁钠|注射用亚胺培南西司他丁钠
注射用头孢唑肟钠|注射用头孢唑肟钠
炎宁糖浆|炎宁糖浆
甲磺酸培氟沙星葡萄糖注射液|甲磺酸培氟沙星葡萄糖注射液
复方磺胺甲噁唑注射液|复方磺胺甲噁唑注射液
复方磺胺甲噁唑分散片|复方磺胺甲噁唑分散片
注射用门冬氨酸洛美沙星|注射用门冬氨酸洛美沙星
硫酸阿米卡星氯化钠注射液|硫酸阿米卡星氯化钠注射液
注射用磷霉素钠|注射用磷霉素钠
复方磺胺嘧啶片|复方磺胺嘧啶片
氟胞嘧啶注射液|氟胞嘧啶注射液
诺氟沙星葡萄糖注射液|诺氟沙星葡萄糖注射液
盐酸洛美沙星氯化钠注射液|盐酸洛美沙星氯化钠注射液
注射用硫酸奈替米星|注射用硫酸奈替米星
呋喃妥因肠溶片|呋喃妥因肠溶片
硫酸奈替米星葡萄糖注射液|硫酸奈替米星葡萄糖注射液
谷氨酸诺氟沙星氯化钠注射液|谷氨酸诺氟沙星氯化钠注射液
注射用五水头孢唑林钠|注射用五水头孢唑林钠
注射用磺苄西林钠|注射用磺苄西林钠
注射用氨曲南|注射用氨曲南
注射用两性霉素B|注射用两性霉素B
头孢氨苄甲氧苄啶片|头孢氨苄甲氧苄啶片
阿莫西林咀嚼片|阿莫西林咀嚼片
黄体酮栓|黄体酮栓
注射用头孢噻肟钠|注射用头孢噻肟钠
鱼腥草注射液|鱼腥草注射液
注射用头孢唑林钠|注射用头孢唑林钠
注射用氨苄西林钠|注射用氨苄西林钠
注射用头孢硫脒|注射用头孢硫脒
甲氧苄啶片|甲氧苄啶片
乳酸加替沙星葡萄糖注射液|乳酸加替沙星葡萄糖注射液
银花泌炎灵片|银花泌炎灵片
硫酸依替米星氯化钠注射液|硫酸依替米星氯化钠注射液
加替沙星葡萄糖注射液|加替沙星葡萄糖注射液
注射用美罗培南|注射用美罗培南
硫酸小诺霉素氯化钠注射液|硫酸小诺霉素氯化钠注射液
乳酸加替沙星氯化钠注射液|乳酸加替沙星氯化钠注射液
注射用硫酸依替米星|注射用硫酸依替米星
甲磺酸加替沙星葡萄糖注射液|甲磺酸加替沙星葡萄糖注射液
甲磺酸加替沙星氯化钠注射液|甲磺酸加替沙星氯化钠注射液
注射用头孢呋辛钠|注射用头孢呋辛钠
盐酸酚苄明注射液|盐酸酚苄明注射液
克林霉素磷酸酯葡萄糖注射液|克林霉素磷酸酯葡萄糖注射液
注射用尿促性素|注射用尿促性素
注射用绒促性素|注射用绒促性素
安坤赞育丸|安坤赞育丸
黄体酮注射液|黄体酮注射液
复方黄体酮注射液|复方黄体酮注射液
双氯芬酸钠片|双氯芬酸钠片
双氯芬酸钠肠溶片|双氯芬酸钠肠溶片
茜芷片|茜芷片
注射用缩宫素|注射用缩宫素
马来酸麦角新碱注射液|马来酸麦角新碱注射液
缩宫素注射液|缩宫素注射液
氨甲环酸氯化钠注射液|氨甲环酸氯化钠注射液
氨甲环酸注射液|氨甲环酸注射液
甲硝唑片|甲硝唑片
盐酸特比萘芬乳膏|盐酸特比萘芬乳膏
注射用头孢噻肟钠舒巴坦钠|注射用头孢噻肟钠舒巴坦钠
注射用乳糖酸阿奇霉素|注射用乳糖酸阿奇霉素
马来酸阿奇霉素注射液|马来酸阿奇霉素注射液
注射用哌拉西林钠他唑巴坦钠|注射用哌拉西林钠他唑巴坦钠
盐酸阿奇霉素注射液|盐酸阿奇霉素注射液
活血解毒丸|活血解毒丸
乳糖酸阿奇霉素注射液|乳糖酸阿奇霉素注射液
蟾酥锭|蟾酥锭
丁苯酞氯化钠注射液|丁苯酞氯化钠注射液
田七痛经胶囊|田七痛经胶囊
对乙酰氨基酚异丙嗪注射液|对乙酰氨基酚异丙嗪注射液
氨酚异丙嗪注射液|氨酚异丙嗪注射液
阿司匹林维生素C肠溶片|阿司匹林维生素C肠溶片
复方布洛芬片|复方布洛芬片
去痛片|去痛片
妇科十味片|妇科十味片
阿莫西林肠溶片|阿莫西林肠溶片
阿司匹林泡腾片|阿司匹林泡腾片
盐酸阿米洛利片|盐酸阿米洛利片
得生丸|得生丸
盐酸可乐定片|盐酸可乐定片
阿司匹林片|阿司匹林片
新霉素氟轻松乳膏|新霉素氟轻松乳膏
八珍益母膏|八珍益母膏
丙酸睾酮注射液|丙酸睾酮注射液
愈伤灵胶囊|愈伤灵胶囊
己烯雌酚片|己烯雌酚片
复方氯化钠注射液|复方氯化钠注射液
奥硝唑氯化钠注射液|奥硝唑氯化钠注射液
注射用门冬氨酸钾镁|注射用门冬氨酸钾镁
酮咯酸氨丁三醇注射液|酮咯酸氨丁三醇注射液
克霉唑药膜|克霉唑药膜
盐酸利托君片|盐酸利托君片
注射用盐酸利托君|注射用盐酸利托君
盐酸利托君注射液|盐酸利托君注射液
注射用白眉蛇毒血凝酶|注射用白眉蛇毒血凝酶
硫酸镁注射液|硫酸镁注射液
注射用醋酸丙氨瑞林|注射用醋酸丙氨瑞林
尼群洛尔片|尼群洛尔片
碘化油注射液|碘化油注射液
维生素D2注射液|维生素D2注射液
复方电解质葡萄糖MG3注射液|复方电解质葡萄糖MG3注射液
注射用氯化钾|注射用氯化钾
氯化钾葡萄糖注射液|氯化钾葡萄糖注射液
枸橼酸钾颗粒|枸橼酸钾颗粒
门冬氨酸钾镁葡萄糖注射液|门冬氨酸钾镁葡萄糖注射液
门冬氨酸钾镁注射液|门冬氨酸钾镁注射液
氯化钾注射液|氯化钾注射液
阿仑膦酸钠维D3片|阿仑膦酸钠维D3片
骨肽氯化钠注射液|骨肽氯化钠注射液
阿仑膦酸钠片|阿仑膦酸钠片
鲑降钙素注射液|鲑降钙素注射液
注射用氯膦酸二钠|注射用氯膦酸二钠
葡萄糖酸钙含片|葡萄糖酸钙含片
抗骨质增生丸|抗骨质增生丸
葡萄糖酸钙片|葡萄糖酸钙片
盐酸金霉素软膏|盐酸金霉素软膏
注射用蔗糖铁|注射用蔗糖铁
山梨醇铁注射液|山梨醇铁注射液
葡萄糖酸亚铁片|葡萄糖酸亚铁片
硫酸亚铁片|硫酸亚铁片
口服维生素D2葡萄糖|口服维生素D2葡萄糖
注射用水溶性维生素|注射用水溶性维生素
斑蝥酸钠维生素B6注射液|斑蝥酸钠维生素B6注射液
维生素C口含片|维生素C口含片
维生素K1片|维生素K1片
果味维生素C片|果味维生素C片
维生素K1注射液|维生素K1注射液
维生素B6片|维生素B6片
复合维生素B片|复合维生素B片
维生素C片|维生素C片
维生素B2|维生素B2
维生素B2注射液|维生素B2注射液
维生素C银翘片|维生素C银翘片
阿司匹林维生素C咀嚼片|阿司匹林维生素C咀嚼片
维生素C含片|维生素C含片
维生素B1注射液|维生素B1注射液
维生素B12片|维生素B12片
维生素B1|维生素B1
维生素B1片|维生素B1片
氯化钙注射液|氯化钙注射液
地高辛口服溶液|地高辛口服溶液
注射用长春西汀|注射用长春西汀
烟酸注射液|烟酸注射液
腺苷钴胺片|腺苷钴胺片
注射用甲钴胺|注射用甲钴胺
亚硫酸氢钠甲萘醌片|亚硫酸氢钠甲萘醌片
葡萄糖氯化钙注射液|葡萄糖氯化钙注射液
四维葡萄糖散|四维葡萄糖散
注射用烟酸|注射用烟酸
葡萄糖粉剂|葡萄糖粉剂
甲钴胺注射液|甲钴胺注射液
口服葡萄糖|口服葡萄糖
亚硫酸氢钠甲萘醌注射液|亚硫酸氢钠甲萘醌注射液
口服五维葡萄糖|口服五维葡萄糖
干酵母片|干酵母片
果糖二磷酸钠注射液|果糖二磷酸钠注射液
盐酸胺碘酮注射液|盐酸胺碘酮注射液
注射用奥美拉唑钠|注射用奥美拉唑钠
高三尖杉酯碱注射液|高三尖杉酯碱注射液
注射用盐酸多巴酚丁胺|注射用盐酸多巴酚丁胺
注射用双氯芬酸钠利多卡因|注射用双氯芬酸钠利多卡因
盐酸倍他司汀片|盐酸倍他司汀片
盐酸艾司洛尔注射液|盐酸艾司洛尔注射液
注射用环磷腺苷葡胺|注射用环磷腺苷葡胺
三尖杉酯碱注射液|三尖杉酯碱注射液
盐酸多巴酚丁胺注射液|盐酸多巴酚丁胺注射液
盐酸胺碘酮分散片|盐酸胺碘酮分散片
氨苯蝶啶片|氨苯蝶啶片
盐酸金刚烷胺片|盐酸金刚烷胺片
环磷腺苷葡胺葡萄糖注射液|环磷腺苷葡胺葡萄糖注射液
环磷腺苷葡胺注射液|环磷腺苷葡胺注射液
枸橼酸托烷司琼注射液|枸橼酸托烷司琼注射液
血液滤过置换液|血液滤过置换液
注射用盐酸胺碘酮|注射用盐酸胺碘酮
硫酸奎尼丁片|硫酸奎尼丁片
马来酸曲美布汀缓释片|马来酸曲美布汀缓释片
盐酸多巴胺注射液|盐酸多巴胺注射液
盐酸普罗帕酮注射液|盐酸普罗帕酮注射液
双氯芬酸钠盐酸利多卡因注射液|双氯芬酸钠盐酸利多卡因注射液
注射用天麻素|注射用天麻素
谷维素片|谷维素片
盐酸硫必利片|盐酸硫必利片
人血白蛋白|人血白蛋白
叶酸维B12片|叶酸维B12片
烟酰胺片|烟酰胺片
司坦唑醇片|司坦唑醇片
注射用果糖二磷酸钠|注射用果糖二磷酸钠
注射用腺苷钴胺|注射用腺苷钴胺
盐酸维拉帕米片|盐酸维拉帕米片
氨肽素硫酸锌片|氨肽素硫酸锌片
硝苯地平片|硝苯地平片
注射用盐酸川芎嗪|注射用盐酸川芎嗪
硝酸异山梨酯葡萄糖注射液|硝酸异山梨酯葡萄糖注射液
注射用硝酸异山梨酯|注射用硝酸异山梨酯
马来酸氨氯地平片|马来酸氨氯地平片
苯磺酸氨氯地平片|苯磺酸氨氯地平片
注射用己酮可可碱|注射用己酮可可碱
黄芪注射液|黄芪注射液
氢氯噻嗪片|氢氯噻嗪片
参麦注射液|参麦注射液
盐酸贝那普利片|盐酸贝那普利片
毒毛花苷K注射液|毒毛花苷K注射液
氨苯蝶啶氢氯噻嗪片|氨苯蝶啶氢氯噻嗪片
注射用布美他尼|注射用布美他尼
辅酶Q10注射液|辅酶Q10注射液
呋塞米注射液|呋塞米注射液
硝酸甘油氯化钠注射液|硝酸甘油氯化钠注射液
米力农葡萄糖注射液|米力农葡萄糖注射液
硝酸甘油片|硝酸甘油片
硝酸异山梨酯氯化钠注射液|硝酸异山梨酯氯化钠注射液
硝酸异山梨酯片|硝酸异山梨酯片
注射用尿激酶|注射用尿激酶
注射用降纤酶|注射用降纤酶
注射用盐酸艾司洛尔|注射用盐酸艾司洛尔
西洛他唑片|西洛他唑片
长春西汀氯化钠注射液|长春西汀氯化钠注射液
消眩止晕片|消眩止晕片
刺五加注射液|刺五加注射液
盐酸吡硫醇氯化钠注射液|盐酸吡硫醇氯化钠注射液
长春西汀葡萄糖注射液|长春西汀葡萄糖注射液
盐酸吡硫醇注射液|盐酸吡硫醇注射液
注射用盐酸吡硫醇|注射用盐酸吡硫醇
氨酪酸氯化钠注射液|氨酪酸氯化钠注射液
爱维心口服液|爱维心口服液
桂利嗪片|桂利嗪片
杏芎氯化钠注射液|杏芎氯化钠注射液
注射用前列地尔|注射用前列地尔
烟酸肌醇酯片|烟酸肌醇酯片
琥珀酰明胶注射液|琥珀酰明胶注射液
秦归活络口服液|秦归活络口服液
盐酸倍他司汀氯化钠注射液|盐酸倍他司汀氯化钠注射液
重酒石酸去甲肾上腺素注射液|重酒石酸去甲肾上腺素注射液
重酒石酸间羟胺注射液|重酒石酸间羟胺注射液
注射用环磷腺苷|注射用环磷腺苷
环磷腺苷葡萄糖注射液|环磷腺苷葡萄糖注射液
酒石酸美托洛尔片|酒石酸美托洛尔片
单硝酸异山梨酯缓释片|单硝酸异山梨酯缓释片
门冬氨酸钾镁片|门冬氨酸钾镁片
注射用头孢西丁钠|注射用头孢西丁钠
注射用还原型谷胱甘肽钠|注射用还原型谷胱甘肽钠
注射用还原型谷胱甘肽|注射用还原型谷胱甘肽
双氯芬酸钠利多卡因注射液|双氯芬酸钠利多卡因注射液
重组人血小板生成素注射液|重组人血小板生成素注射液
香砂养胃软胶囊|香砂养胃软胶囊
阿司匹林分散片|阿司匹林分散片
小儿复方阿司匹林片|小儿复方阿司匹林片
复方普萘洛尔咖啡因片|复方普萘洛尔咖啡因片
复方水杨酸甲酯薄荷脑油|复方水杨酸甲酯薄荷脑油
复方磷酸可待因片|复方磷酸可待因片
齿痛冰硼散|齿痛冰硼散
玻璃酸钠注射液|玻璃酸钠注射液
复方银花解毒颗粒|复方银花解毒颗粒
银黄注射液|银黄注射液
氨苄西林丙磺舒分散片|氨苄西林丙磺舒分散片
复方忍冬藤阿司匹林片|复方忍冬藤阿司匹林片
脂康颗粒|脂康颗粒
盐酸洛美沙星滴耳液|盐酸洛美沙星滴耳液
乙肝养阴活血颗粒|乙肝养阴活血颗粒
二十味肉豆蔻丸|二十味肉豆蔻丸
避瘟散|避瘟散
川芎茶调口服液|川芎茶调口服液
千柏鼻炎片|千柏鼻炎片
色甘酸钠滴鼻液|色甘酸钠滴鼻液
复方氨酚苯海拉明片|复方氨酚苯海拉明片
正红花油|正红花油
曲安奈德鼻喷雾剂|曲安奈德鼻喷雾剂
依托泊苷注射液|依托泊苷注射液
醋酸曲安奈德注射液|醋酸曲安奈德注射液
退热清咽颗粒|退热清咽颗粒
活血止痛软胶囊|活血止痛软胶囊
痔血丸|痔血丸
四味土木香散|四味土木香散
内消瘰疬丸|内消瘰疬丸
葡萄糖酸钙维D2咀嚼片|葡萄糖酸钙维D2咀嚼片
乙肝益气解郁颗粒|乙肝益气解郁颗粒
氨甲苯酸葡萄糖注射液|氨甲苯酸葡萄糖注射液
复合磷酸氢钾注射液|复合磷酸氢钾注射液
蛇毒血凝酶注射液|蛇毒血凝酶注射液
注射用两性霉素B脂质体|注射用两性霉素B脂质体
复方鲜竹沥液|复方鲜竹沥液
盐酸氯雷他定片|盐酸氯雷他定片
滴眼用利福平|滴眼用利福平
甘草酸氯丙那林含片|甘草酸氯丙那林含片
疏风解毒胶囊|疏风解毒胶囊
安乃近氯丙嗪注射液|安乃近氯丙嗪注射液
复方金刚烷胺氨基比林片|复方金刚烷胺氨基比林片
流感丸|流感丸
石斛夜光颗粒|石斛夜光颗粒
硫普罗宁注射液|硫普罗宁注射液
安宫降压丸|安宫降压丸
利福平滴眼液|利福平滴眼液
安宫牛黄丸|安宫牛黄丸
氟米龙滴眼液|氟米龙滴眼液
氯霉素滴眼液|氯霉素滴眼液
小儿至宝丸|小儿至宝丸
地塞米松磷酸钠滴眼液|地塞米松磷酸钠滴眼液
桂黄清热颗粒|桂黄清热颗粒
复方双肼屈嗪片|复方双肼屈嗪片
硝酸毛果芸香碱注射液|硝酸毛果芸香碱注射液
奥沙利铂甘露醇注射液|奥沙利铂甘露醇注射液
消炎利胆软胶囊|消炎利胆软胶囊
阿昔莫司分散片|阿昔莫司分散片
呋麻滴鼻液|呋麻滴鼻液
盐酸西替利嗪口腔崩解片|盐酸西替利嗪口腔崩解片
祛痰止咳胶囊|祛痰止咳胶囊
酒石酸溴莫尼定滴眼液|酒石酸溴莫尼定滴眼液
硝酸毛果芸香碱滴眼液|硝酸毛果芸香碱滴眼液
固本丸|固本丸
麻仁滋脾丸|麻仁滋脾丸
胃痛宁片|胃痛宁片
小败毒膏|小败毒膏
清宁丸|清宁丸
三金颗粒|三金颗粒
注射用盐酸昂丹司琼|注射用盐酸昂丹司琼
甲巯咪唑片|甲巯咪唑片
阿昔洛韦滴眼液|阿昔洛韦滴眼液
感冒清热颗粒|感冒清热颗粒
神农镇痛膏|神农镇痛膏
阿司匹林缓释片|阿司匹林缓释片
硫酸吗啡栓|硫酸吗啡栓
盐酸布桂嗪片|盐酸布桂嗪片
硫酸吗啡缓释片|硫酸吗啡缓释片
正柴胡饮颗粒|正柴胡饮颗粒
石斛明目丸|石斛明目丸
牛黄清火丸|牛黄清火丸
注射用促皮质素|注射用促皮质素
盐酸洛美沙星注射液|盐酸洛美沙星注射液
注射用氨苄西林钠舒巴坦钠|注射用氨苄西林钠舒巴坦钠
六甲蜜胺肠溶片|六甲蜜胺肠溶片
复方雪参胶囊|复方雪参胶囊
注射用顺铂|注射用顺铂
顺铂注射液|顺铂注射液
左氧氟沙星葡萄糖注射液|左氧氟沙星葡萄糖注射液
复方地蒽酚软膏|复方地蒽酚软膏
甲磺酸瑞波西汀片|甲磺酸瑞波西汀片
祖师麻膏药|祖师麻膏药
盐酸昂丹司琼口腔崩解片|盐酸昂丹司琼口腔崩解片
盐酸昂丹司琼葡萄糖注射液|盐酸昂丹司琼葡萄糖注射液
复方香薷水|复方香薷水
九味牛黄丸|九味牛黄丸
茵栀黄注射液|茵栀黄注射液
六合定中丸|六合定中丸
多潘立酮分散片|多潘立酮分散片
硫酸西索米星氯化钠注射液|硫酸西索米星氯化钠注射液
秋泻灵颗粒|秋泻灵颗粒
盐酸赖氨酸氯化钠注射液|盐酸赖氨酸氯化钠注射液
乌拉地尔氯化钠注射液|乌拉地尔氯化钠注射液
缬沙坦片|缬沙坦片
乌拉地尔葡萄糖注射液|乌拉地尔葡萄糖注射液
二十五味大汤丸|二十五味大汤丸
氯沙坦钾片|氯沙坦钾片
复方胰酶片|复方胰酶片
注射用盐酸乌拉地尔|注射用盐酸乌拉地尔
盐酸尼卡地平注射液|盐酸尼卡地平注射液
盐酸普萘洛尔片|盐酸普萘洛尔片
乌拉地尔注射液|乌拉地尔注射液
溴甲东莨菪碱片|溴甲东莨菪碱片
西咪替丁氯化钠注射液|西咪替丁氯化钠注射液
二维呋喃唑酮片|二维呋喃唑酮片
海桂胶囊|海桂胶囊
注射用特利加压素|注射用特利加压素
盐酸雷尼替丁氯化钠注射液|盐酸雷尼替丁氯化钠注射液
注射用生长抑素|注射用生长抑素
盐酸雷尼替丁咀嚼片|盐酸雷尼替丁咀嚼片
法莫替丁咀嚼片|法莫替丁咀嚼片
尼群地平片|尼群地平片
盐酸索他洛尔注射液|盐酸索他洛尔注射液
注射用盐酸索他洛尔|注射用盐酸索他洛尔
黄芪建中丸|黄芪建中丸
多库酯钠片|多库酯钠片
甲基多巴片|甲基多巴片
盐酸莫雷西嗪片|盐酸莫雷西嗪片
辛伐他汀咀嚼片|辛伐他汀咀嚼片
注射用硫辛酸|注射用硫辛酸
刺五加脑灵液|刺五加脑灵液
阿莫西林片|阿莫西林片
盐酸奈福泮葡萄糖注射液|盐酸奈福泮葡萄糖注射液
硫酸庆大霉素缓释片|硫酸庆大霉素缓释片
苦碟子注射液|苦碟子注射液
复方乳酸钠山梨醇注射液|复方乳酸钠山梨醇注射液
替加氟氯化钠注射液|替加氟氯化钠注射液
香砂六君片|香砂六君片
异烟肼片|异烟肼片
卡维地洛分散片|卡维地洛分散片
五灵胶囊|五灵胶囊
十香返生丸|十香返生丸
护肝布祖热颗粒|护肝布祖热颗粒
清热卡森颗粒|清热卡森颗粒
玫瑰花口服液|玫瑰花口服液
盐酸消旋山莨菪碱氯化钠注射液|盐酸消旋山莨菪碱氯化钠注射液
清气化痰丸|清气化痰丸
盐酸林可霉素葡萄糖注射液|盐酸林可霉素葡萄糖注射液
地塞米松片|地塞米松片
盐酸氨溴索颗粒|盐酸氨溴索颗粒
注射用法莫替丁|注射用法莫替丁
法莫替丁氯化钠注射液|法莫替丁氯化钠注射液
灯盏花素片|灯盏花素片
亮菌甲素氯化钠注射液|亮菌甲素氯化钠注射液
亮菌甲素葡萄糖注射液|亮菌甲素葡萄糖注射液
盐酸奈福泮氯化钠注射液|盐酸奈福泮氯化钠注射液
法莫替丁葡萄糖注射液|法莫替丁葡萄糖注射液
丹香葡萄糖滴注液|丹香葡萄糖滴注液
注射用唑来膦酸|注射用唑来膦酸
注射用盐酸柔红霉素|注射用盐酸柔红霉素
帕米膦酸二钠葡萄糖注射液|帕米膦酸二钠葡萄糖注射液
氯膦酸二钠片|氯膦酸二钠片
硝酸毛果芸香碱片|硝酸毛果芸香碱片
甲氧氯普胺片|甲氧氯普胺片
复方呋塞米片|复方呋塞米片
萘普生钠氯化钠注射液|萘普生钠氯化钠注射液
注射用三磷酸腺苷辅酶胰岛素|注射用三磷酸腺苷辅酶胰岛素
扎来普隆口腔崩解片|扎来普隆口腔崩解片
醋氯芬酸肠溶片|醋氯芬酸肠溶片
复方地西泮片|复方地西泮片
烟酸占替诺注射液|烟酸占替诺注射液
尼群地平分散片|尼群地平分散片
异甘草酸镁注射液|异甘草酸镁注射液
双环醇片|双环醇片
大黄碳酸氢钠片|大黄碳酸氢钠片
龙胆碳酸氢钠片|龙胆碳酸氢钠片
藻酸双酯钠氯化钠注射液|藻酸双酯钠氯化钠注射液
归芪活血胶囊|归芪活血胶囊
柳氮磺吡啶栓|柳氮磺吡啶栓
醋酸可的松片|醋酸可的松片
柳氮磺吡啶肠溶片|柳氮磺吡啶肠溶片
注射用放线菌素D|注射用放线菌素D
硫酸阿托品片|硫酸阿托品片
颈通颗粒|颈通颗粒
小儿鞣酸小檗碱片|小儿鞣酸小檗碱片
十五味黑药丸|十五味黑药丸
洛伐他汀片|洛伐他汀片
盐酸表柔比星注射液|盐酸表柔比星注射液
卡莫氟片|卡莫氟片
去氧氟尿苷分散片|去氧氟尿苷分散片
复方氟尿嘧啶注射液|复方氟尿嘧啶注射液
注射用甲硫氨酸维B1|注射用甲硫氨酸维B1
氟尿嘧啶片|氟尿嘧啶片
红花清肝十三味丸|红花清肝十三味丸
二乙酰氨乙酸乙二胺葡萄糖注射液|二乙酰氨乙酸乙二胺葡萄糖注射液
注射用乌司他丁|注射用乌司他丁
氢溴酸山莨菪碱片|氢溴酸山莨菪碱片
牛黄至宝丸|牛黄至宝丸
琥珀酸亚铁片|琥珀酸亚铁片
沉香化滞丸|沉香化滞丸
舒肝健胃丸|舒肝健胃丸
肿节风注射液|肿节风注射液
芪骨胶囊|芪骨胶囊
桂附理中丸|桂附理中丸
氟罗沙星甘露醇注射液|氟罗沙星甘露醇注射液
利福平注射液|利福平注射液
益母草注射液|益母草注射液
十五味沉香丸|十五味沉香丸
乙胺利福异烟片|乙胺利福异烟片
蔗糖铁注射液|蔗糖铁注射液
地衣芽孢杆菌活菌颗粒|地衣芽孢杆菌活菌颗粒
盐酸赖氨酸葡萄糖注射液|盐酸赖氨酸葡萄糖注射液
京万红软膏|京万红软膏
注射用盐酸环丙沙星|注射用盐酸环丙沙星
盐酸环丙沙星葡萄糖注射液|盐酸环丙沙星葡萄糖注射液
盐酸环丙沙星注射液|盐酸环丙沙星注射液
注射用盐酸博来霉素|注射用盐酸博来霉素
克林霉素磷酸酯阴道用乳膏|克林霉素磷酸酯阴道用乳膏
甲硝唑注射液|甲硝唑注射液
甲硝唑葡萄糖注射液|甲硝唑葡萄糖注射液
注射用重组人组织型纤溶酶原激酶衍生物|注射用重组人组织型纤溶酶原激酶衍生物
氟尿嘧啶氯化钠注射液|氟尿嘧啶氯化钠注射液
酒石酸长春瑞滨注射液|酒石酸长春瑞滨注射液
注射用洛铂|注射用洛铂
塞替派注射液|塞替派注射液
醋酸甲羟孕酮分散片|醋酸甲羟孕酮分散片
氟尿嘧啶注射液|氟尿嘧啶注射液
盐酸米托蒽醌葡萄糖注射液|盐酸米托蒽醌葡萄糖注射液
注射用硫酸长春新碱|注射用硫酸长春新碱
甲氨蝶呤片|甲氨蝶呤片
甲睾酮片|甲睾酮片
多西他赛注射液|多西他赛注射液
注射用氟尿嘧啶|注射用氟尿嘧啶
更昔洛韦钠注射液|更昔洛韦钠注射液
注射用更昔洛韦|注射用更昔洛韦
甲巯咪唑肠溶片|甲巯咪唑肠溶片
注射用哌拉西林钠舒巴坦钠|注射用哌拉西林钠舒巴坦钠
吲哚美辛三七冰片栓|吲哚美辛三七冰片栓
复方炔雌醇片|复方炔雌醇片
倍他米松片|倍他米松片
复方倍氯米松樟脑乳膏|复方倍氯米松樟脑乳膏
水杨酸苯佐卡因软膏|水杨酸苯佐卡因软膏
醋酸氟轻松软膏|醋酸氟轻松软膏
盐酸二氧异丙嗪片|盐酸二氧异丙嗪片
复方克罗米通乳膏|复方克罗米通乳膏
盐酸二氧丙嗪片|盐酸二氧丙嗪片
注射用阿莫西林钠舒巴坦钠|注射用阿莫西林钠舒巴坦钠
林可霉素维B6乳膏|林可霉素维B6乳膏
盐酸苯海拉明片|盐酸苯海拉明片
醋酸泼尼松龙注射液|醋酸泼尼松龙注射液
泼尼松龙片|泼尼松龙片
诺氟沙星乳膏|诺氟沙星乳膏
盐酸双氧异丙嗪片|盐酸双氧异丙嗪片
氯化钙溴化钠注射液|氯化钙溴化钠注射液
氯雷他定口腔崩解片|氯雷他定口腔崩解片
克林霉素甲硝唑搽剂|克林霉素甲硝唑搽剂
葡萄糖酸钙维D2散|葡萄糖酸钙维D2散
缩合葡萄糖氯化钠注射液|缩合葡萄糖氯化钠注射液
硫酸妥布霉素氯化钠注射液|硫酸妥布霉素氯化钠注射液
右旋糖酐20氯化钠注射液|右旋糖酐20氯化钠注射液
氟哌利多注射液|氟哌利多注射液
硫酸妥布霉素注射液|硫酸妥布霉素注射液
复方氧化锌软膏|复方氧化锌软膏
虎黄烧伤搽剂|虎黄烧伤搽剂
积雪苷霜软膏|积雪苷霜软膏
复方氢化可的松新霉素乳膏|复方氢化可的松新霉素乳膏
硫磺硼砂乳膏|硫磺硼砂乳膏
阿达帕林凝胶|阿达帕林凝胶
甘草酸二铵氯化钠注射液|甘草酸二铵氯化钠注射液
复方水杨酸苯胺甲酯乳膏|复方水杨酸苯胺甲酯乳膏
复方水杨酸苯甲酸搽剂|复方水杨酸苯甲酸搽剂
复方酮康唑软膏|复方酮康唑软膏
复方酮康唑乳膏|复方酮康唑乳膏
克罗米通乳膏|克罗米通乳膏
桉油尿素乳膏|桉油尿素乳膏
咪康唑氯倍他索乳膏|咪康唑氯倍他索乳膏
马来酸氯苯那敏片|马来酸氯苯那敏片
氢化可的松片|氢化可的松片
氢化可的松注射液|氢化可的松注射液
注射用重组人干扰素α1b|注射用重组人干扰素α1b
盐酸伐昔洛韦片|盐酸伐昔洛韦片
阿昔洛韦颗粒|阿昔洛韦颗粒
阿昔洛韦乳膏|阿昔洛韦乳膏
复方地塞米松乳膏|复方地塞米松乳膏
复方醋酸地塞米松乳膏|复方醋酸地塞米松乳膏
醋酸氟轻松乳膏|醋酸氟轻松乳膏
六应丸|六应丸
瓜蒌皮注射液|瓜蒌皮注射液
蛇胆川贝液|蛇胆川贝液
氨肽素片|氨肽素片
参蛇花痔疮膏|参蛇花痔疮膏
筋骨伤喷雾剂|筋骨伤喷雾剂
膦甲酸钠葡萄糖注射液|膦甲酸钠葡萄糖注射液
鱼石脂颠茄软膏|鱼石脂颠茄软膏
利巴韦林滴眼液|利巴韦林滴眼液
复方紫草油|复方紫草油
烫伤油|烫伤油
尿素维E乳膏|尿素维E乳膏
拔毒膏|拔毒膏
注射用盐酸万古霉素|注射用盐酸万古霉素
醋酸氟轻松冰片乳膏|醋酸氟轻松冰片乳膏
小儿百寿丸|小儿百寿丸
小儿感冒舒颗粒|小儿感冒舒颗粒
盐酸甲氯芬酯分散片|盐酸甲氯芬酯分散片
氟哌啶醇注射液|氟哌啶醇注射液
碘佛醇注射液|碘佛醇注射液
齐多拉米双夫定片|齐多拉米双夫定片
注射用丙戊酸钠|注射用丙戊酸钠
理中丸|理中丸
复方茶碱麻黄碱片|复方茶碱麻黄碱片
注射用盐酸哌甲酯|注射用盐酸哌甲酯
明目地黄丸|明目地黄丸
黄连羊肝片|黄连羊肝片
注射用利巴韦林|注射用利巴韦林
琥乙红霉素片|琥乙红霉素片
耳聋左慈丸|耳聋左慈丸
尼莫地平片|尼莫地平片
头孢拉定片|头孢拉定片
依托红霉素片|依托红霉素片
莪术油葡萄糖注射液|莪术油葡萄糖注射液
盐酸格拉司琼口腔崩解片|盐酸格拉司琼口腔崩解片
硫酸沙丁胺醇注射液|硫酸沙丁胺醇注射液
甘油磷酸钠注射液|甘油磷酸钠注射液
硫酸特布他林氯化钠注射液|硫酸特布他林氯化钠注射液
盐酸丁卡因凝胶|盐酸丁卡因凝胶
生理氯化钠溶液|生理氯化钠溶液
硫普罗宁片|硫普罗宁片
齐多夫定注射液|齐多夫定注射液
盐酸维拉帕米注射液|盐酸维拉帕米注射液
盐酸苯海拉明注射液|盐酸苯海拉明注射液
盐酸精氨酸注射液|盐酸精氨酸注射液
复方甘草酸单铵S氯化钠注射液|复方甘草酸单铵S氯化钠注射液
葡醛酸钠氯化钠注射液|葡醛酸钠氯化钠注射液
复方盐酸雷尼替丁片|复方盐酸雷尼替丁片
锝[99mTc]双半胱氨酸注射液|锝[99mTc]双半胱氨酸注射液
锝[99mTc]亚甲基二膦酸盐注射液|锝[99mTc]亚甲基二膦酸盐注射液
锝[99mTc]二巯丁二酸盐注射液|锝[99mTc]二巯丁二酸盐注射液
瑞舒伐他汀钙分散片|瑞舒伐他汀钙分散片
注射用氨甲苯酸|注射用氨甲苯酸
注射用替考拉宁|注射用替考拉宁
盐酸法舒地尔注射液|盐酸法舒地尔注射液
注射用替加环素|注射用替加环素
氨酚曲马多片|氨酚曲马多片
注射用盐酸阿糖胞苷|注射用盐酸阿糖胞苷
复方单硝酸异山梨酯缓释片|复方单硝酸异山梨酯缓释片
罗通定口腔崩解片|罗通定口腔崩解片
锝[99mTc]聚合白蛋白注射液|锝[99mTc]聚合白蛋白注射液
锝[99mTc]喷替酸盐注射液|锝[99mTc]喷替酸盐注射液
血液滤过置换基础液|血液滤过置换基础液
阿莫西林口腔崩解片|阿莫西林口腔崩解片
复方雷尼替丁片|复方雷尼替丁片
注射用胸腺法新|注射用胸腺法新
佐米曲普坦口腔崩解片|佐米曲普坦口腔崩解片
泛影葡胺注射液|泛影葡胺注射液
羟丁酸钠注射液|羟丁酸钠注射液
盐酸吡格列酮口腔崩解片|盐酸吡格列酮口腔崩解片
注射用乙酰半胱氨酸|注射用乙酰半胱氨酸
盐酸格拉司琼注射液|盐酸格拉司琼注射液
盐酸克仑特罗栓|盐酸克仑特罗栓
去乙酰毛花苷注射液|去乙酰毛花苷注射液
复方泛影葡胺注射液|复方泛影葡胺注射液
注射用盐酸丁卡因|注射用盐酸丁卡因
利福霉素钠氯化钠注射液|利福霉素钠氯化钠注射液
龙血通络胶囊|龙血通络胶囊
注射用哌库溴铵|注射用哌库溴铵
注射用间苯三酚|注射用间苯三酚
六味祛风活络膏|六味祛风活络膏
注射用甲磺酸加贝酯|注射用甲磺酸加贝酯
注射用盐酸精氨酸|注射用盐酸精氨酸
红霉素醋酸锌软膏|红霉素醋酸锌软膏
枸橼酸舍曲林片|枸橼酸舍曲林片
注射用丙氨酰谷氨酰胺|注射用丙氨酰谷氨酰胺
盐酸川芎嗪葡萄糖注射液|盐酸川芎嗪葡萄糖注射液
全氟丙烷人血白蛋白微球注射液|全氟丙烷人血白蛋白微球注射液
盐酸伊立替康注射液|盐酸伊立替康注射液
盐酸洛贝林注射液|盐酸洛贝林注射液
盐酸布比卡因注射液|盐酸布比卡因注射液
胆影葡胺注射液|胆影葡胺注射液
注射用酒石酸长春瑞滨|注射用酒石酸长春瑞滨
泛影酸钠注射液|泛影酸钠注射液
曲克芦丁葡萄糖注射液|曲克芦丁葡萄糖注射液
米力农氯化钠注射液|米力农氯化钠注射液
溴米那普鲁卡因注射液|溴米那普鲁卡因注射液
格列美脲口腔崩解片|格列美脲口腔崩解片
注射用厄他培南钠|注射用厄他培南钠
乙酰谷酰胺葡萄糖注射液|乙酰谷酰胺葡萄糖注射液
葡萄糖氯化钠钾注射液|葡萄糖氯化钠钾注射液
阿司匹林双嘧达莫缓释片|阿司匹林双嘧达莫缓释片
八味沉香丸|八味沉香丸
磷酸川芎嗪氯化钠注射液|磷酸川芎嗪氯化钠注射液
氢溴酸山莨菪碱注射液|氢溴酸山莨菪碱注射液
氟马西尼注射液|氟马西尼注射液
利血平注射液|利血平注射液
肝素钙注射液|肝素钙注射液
氯解磷定注射液|氯解磷定注射液
注射用双嘧达莫|注射用双嘧达莫
贝美格注射液|贝美格注射液
尿通卡克乃其片|尿通卡克乃其片
罗库溴铵注射液|罗库溴铵注射液
注射用甲磺酸齐拉西酮|注射用甲磺酸齐拉西酮
碳酸利多卡因注射液|碳酸利多卡因注射液
替米沙坦分散片|替米沙坦分散片
注射用苯磺顺阿曲库铵|注射用苯磺顺阿曲库铵
尼可刹米注射液|尼可刹米注射液
散风通窍滴丸|散风通窍滴丸
注射用对氨基水杨酸钠|注射用对氨基水杨酸钠
复方电解质葡萄糖注射液-R4A|复方电解质葡萄糖注射液-R4A
利福平异烟肼片|利福平异烟肼片
盐酸格拉司琼片|盐酸格拉司琼片
小儿黄龙颗粒|小儿黄龙颗粒
乳酸米力农葡萄糖注射液|乳酸米力农葡萄糖注射液
川射干黄酮胶囊|川射干黄酮胶囊
注射用恩夫韦肽|注射用恩夫韦肽
酚磺乙胺氯化钠注射液|酚磺乙胺氯化钠注射液
咪唑立宾片|咪唑立宾片
利多布比卡因注射液|利多布比卡因注射液
双嘧达莫注射液|双嘧达莫注射液
注射用胰蛋白酶|注射用胰蛋白酶
复方辣椒碱乳膏|复方辣椒碱乳膏
异福酰胺片|异福酰胺片
盐酸替扎尼定口腔崩解片|盐酸替扎尼定口腔崩解片
碘[131I]化钠口服溶液|碘[131I]化钠口服溶液
大月晶丸|大月晶丸
青霉素皮试剂|青霉素皮试剂
碘番酸片|碘番酸片
鞣酸小檗碱片|鞣酸小檗碱片
复方别嘌醇片|复方别嘌醇片
碘帕醇注射液|碘帕醇注射液
六君子丸|六君子丸
二巯丙磺钠注射液|二巯丙磺钠注射液
低分子量肝素钙注射液|低分子量肝素钙注射液
肠舒通栓|肠舒通栓
更昔洛韦片|更昔洛韦片
盐酸氯丙那林片|盐酸氯丙那林片
琥珀消石颗粒|琥珀消石颗粒
异烟肼维B6片|异烟肼维B6片
儿脾醒颗粒|儿脾醒颗粒
复方丹参喷雾剂|复方丹参喷雾剂
复方电解质葡萄糖注射液-M3B|复方电解质葡萄糖注射液-M3B
复方溴丙胺太林片|复方溴丙胺太林片
脂肪乳氨基酸(17)葡萄糖(11%)注射液|脂肪乳氨基酸(17)葡萄糖(11%)注射液
注射用尼莫地平|注射用尼莫地平
注射用硝卡芥|注射用硝卡芥
口服维D2葡萄糖|口服维D2葡萄糖
磷酸咯萘啶注射液|磷酸咯萘啶注射液
盐酸克林霉素乳膏|盐酸克林霉素乳膏
白百抗痨颗粒|白百抗痨颗粒
冠心苏合滴丸|冠心苏合滴丸
阳和解凝膏|阳和解凝膏
安吖啶注射液|安吖啶注射液
注射用盐酸林可霉素|注射用盐酸林可霉素
丹鹿胶囊|丹鹿胶囊
冠心宁片|冠心宁片
盐酸肼屈嗪片|盐酸肼屈嗪片
硫酸奎宁片|硫酸奎宁片
维他葡萄糖|维他葡萄糖
复方二氧丙嗪茶碱片|复方二氧丙嗪茶碱片
小儿大黄碳酸氢钠片|小儿大黄碳酸氢钠片
调元大补二十五味汤散|调元大补二十五味汤散
肛安栓|肛安栓
亚硝酸异戊酯吸入剂|亚硝酸异戊酯吸入剂
盐酸米那普仑片|盐酸米那普仑片
氢溴酸高乌甲素葡萄糖注射液|氢溴酸高乌甲素葡萄糖注射液
复方葛根氢氯噻嗪片|复方葛根氢氯噻嗪片
白消安片|白消安片
那屈肝素钙注射液|那屈肝素钙注射液
二至丸|二至丸
利奈唑胺葡萄糖注射液|利奈唑胺葡萄糖注射液
定喘膏|定喘膏
双氢青蒿素哌喹片|双氢青蒿素哌喹片
甘桔冰梅片|甘桔冰梅片
盐酸曲普利啶片|盐酸曲普利啶片
甘露醇冲洗液|甘露醇冲洗液
三十五味沉香丸|三十五味沉香丸
利舒康胶囊|利舒康胶囊
磷酸哌喹片|磷酸哌喹片
碘解磷定注射液|碘解磷定注射液
杏贝止咳颗粒|杏贝止咳颗粒
小儿对乙酰氨基酚异丙嗪片|小儿对乙酰氨基酚异丙嗪片
矽肺宁片|矽肺宁片
复方水杨酸酊|复方水杨酸酊
异烟肼注射液|异烟肼注射液
复方电解质葡萄糖R2A注射液|复方电解质葡萄糖R2A注射液
鱼石脂氧化锌软膏|鱼石脂氧化锌软膏
复方电解质葡萄糖注射液-M3A|复方电解质葡萄糖注射液-M3A
硫酸鱼精蛋白注射液|硫酸鱼精蛋白注射液
注射用甲硝唑磷酸二钠|注射用甲硝唑磷酸二钠
丙硫异烟胺片|丙硫异烟胺片
硫酸黏菌素片|硫酸黏菌素片
黑锡丹|黑锡丹
磺胺氧化锌软膏|磺胺氧化锌软膏
乙酰胺注射液|乙酰胺注射液
盐酸二甲弗林注射液|盐酸二甲弗林注射液
神曲消食口服液|神曲消食口服液
复方明矾布比卡因注射液|复方明矾布比卡因注射液
抗狂犬病血清|抗狂犬病血清
破伤风抗毒素|破伤风抗毒素
白喉抗毒素|白喉抗毒素
盐酸去氧肾上腺素注射液|盐酸去氧肾上腺素注射液
注射用盐酸罗哌卡因|注射用盐酸罗哌卡因
间苯三酚注射液|间苯三酚注射液
拔毒生肌散|拔毒生肌散
水杨酸氧化锌软膏|水杨酸氧化锌软膏
乳酸依沙吖啶注射液|乳酸依沙吖啶注射液
注射用依托泊苷|注射用依托泊苷
盐酸罂粟碱片|盐酸罂粟碱片
甲磺酸吉米沙星片|甲磺酸吉米沙星片
复方蒿甲醚片|复方蒿甲醚片
氯丙嗪异丙嗪注射液|氯丙嗪异丙嗪注射液
蚓激酶肠溶片|蚓激酶肠溶片
汉防己甲素注射液|汉防己甲素注射液
丙磺舒片|丙磺舒片
半夏天麻丸|半夏天麻丸
注射用硫代硫酸钠|注射用硫代硫酸钠
盐酸多柔比星注射液|盐酸多柔比星注射液
玛木然止泻胶囊|玛木然止泻胶囊
结石康胶囊|结石康胶囊
复方高滋斑片|复方高滋斑片
磷酸氯喹注射液|磷酸氯喹注射液
丁溴东莨菪碱注射液|丁溴东莨菪碱注射液
去甲斑蝥酸钠氯化钠注射液|去甲斑蝥酸钠氯化钠注射液
浓氯化钠溶液|浓氯化钠溶液
醋酸曲安奈德鼻用喷雾剂|醋酸曲安奈德鼻用喷雾剂
注射用三磷酸腺苷二钠氯化镁|注射用三磷酸腺苷二钠氯化镁
盐酸溴己新注射液|盐酸溴己新注射液
硫酸庆大霉素肠溶片|硫酸庆大霉素肠溶片
注射用那屈肝素钙|注射用那屈肝素钙
钆特酸葡胺注射液|钆特酸葡胺注射液
注射用利福平|注射用利福平
注射用吲哚菁绿|注射用吲哚菁绿
莲必治注射液|莲必治注射液
珍黄安宫片|珍黄安宫片
养正消积胶囊|养正消积胶囊
醋酸氢化可的松注射液|醋酸氢化可的松注射液
红霉素片|红霉素片
依托咪酯注射液|依托咪酯注射液
抗五步蛇毒血清|抗五步蛇毒血清
抗银环蛇毒血清|抗银环蛇毒血清
抗蝮蛇毒血清|抗蝮蛇毒血清
盐酸格拉司琼分散片|盐酸格拉司琼分散片
通便宁片|通便宁片
注射用磷酸氟达拉滨|注射用磷酸氟达拉滨
注射用二巯丁二钠|注射用二巯丁二钠
黄根片|黄根片
注射用盐酸普鲁卡因|注射用盐酸普鲁卡因
注射用硫酸普拉睾酮钠|注射用硫酸普拉睾酮钠
理中片|理中片
盐酸罗通定片|盐酸罗通定片
二氧丙嗪苯丙哌林片|二氧丙嗪苯丙哌林片
盐酸氯米帕明注射液|盐酸氯米帕明注射液
止喘灵注射液|止喘灵注射液
氢氯噻嗪可乐定片|氢氯噻嗪可乐定片
氯化琥珀胆碱注射液|氯化琥珀胆碱注射液
扭伤归胶囊|扭伤归胶囊
硫酸庆大霉素泡腾片|硫酸庆大霉素泡腾片
注射用精氨酸阿司匹林|注射用精氨酸阿司匹林
盐酸尼卡地平氯化钠注射液|盐酸尼卡地平氯化钠注射液
消渴康颗粒|消渴康颗粒
葡萄糖酸钙氯化钠注射液|葡萄糖酸钙氯化钠注射液
盐酸溴己新葡萄糖注射液|盐酸溴己新葡萄糖注射液
九味熄风颗粒|九味熄风颗粒
异丙托溴铵气雾剂|异丙托溴铵气雾剂
双重造影产气剂|双重造影产气剂
盐酸普鲁卡因氯化钠注射液|盐酸普鲁卡因氯化钠注射液
亚甲蓝注射液|亚甲蓝注射液
猪苓多糖注射液|猪苓多糖注射液
钠钾镁钙葡萄糖注射液|钠钾镁钙葡萄糖注射液
二巯丙醇注射液|二巯丙醇注射液
锝[99mTc]依替菲宁注射液|锝[99mTc]依替菲宁注射液
抗眼镜蛇毒血清|抗眼镜蛇毒血清
苦黄颗粒|苦黄颗粒
香砂理中丸|香砂理中丸
养阴生血合剂|养阴生血合剂
盐酸氯普噻吨注射液|盐酸氯普噻吨注射液
甲异靛片|甲异靛片
亚硝酸钠注射液|亚硝酸钠注射液
恩氟烷|恩氟烷
双肼屈嗪利血平片|双肼屈嗪利血平片
宽胸气雾剂|宽胸气雾剂
注射用头孢曲松钠舒巴坦钠|注射用头孢曲松钠舒巴坦钠
纤溶酶注射液|纤溶酶注射液
甘草酸单铵半胱氨酸氯化钠注射液|甘草酸单铵半胱氨酸氯化钠注射液
灯盏花素葡萄糖注射液|灯盏花素葡萄糖注射液
注射用达托霉素|注射用达托霉素
注射用呋脲苄青霉素钾|注射用呋脲苄青霉素钾
依地酸钙钠片|依地酸钙钠片
结核菌素纯蛋白衍生物|结核菌素纯蛋白衍生物
庆大霉素甲氧苄啶注射液|庆大霉素甲氧苄啶注射液
硼酸氧化锌软膏|硼酸氧化锌软膏
复方苯海拉明克罗米通乳膏|复方苯海拉明克罗米通乳膏
板蓝根滴眼液|板蓝根滴眼液
白消安注射液|白消安注射液
复方水杨酸苯胺甲酯乳膏剂|复方水杨酸苯胺甲酯乳膏剂
盐酸丁卡因注射液|盐酸丁卡因注射液
克痢痧胶囊|克痢痧胶囊
儿童清咽解热口服液|儿童清咽解热口服液
注射用双半胱氨酸|注射用双半胱氨酸
芩香清解口服液|芩香清解口服液
注射用苯磺酸阿曲库铵|注射用苯磺酸阿曲库铵
金钱胆通颗粒|金钱胆通颗粒
安神补心六味丸|安神补心六味丸
碘美普尔注射液|碘美普尔注射液
异丙托溴铵吸入溶液|异丙托溴铵吸入溶液
细辛脑氯化钠注射液|细辛脑氯化钠注射液
赖诺普利氢氯噻嗪片|赖诺普利氢氯噻嗪片
双氯芬酸钾分散片|双氯芬酸钾分散片
炎琥宁氯化钠注射液|炎琥宁氯化钠注射液
多索茶碱氯化钠注射液|多索茶碱氯化钠注射液
盐酸帕洛诺司琼注射液|盐酸帕洛诺司琼注射液
复方戊酸雌二醇片|复方戊酸雌二醇片
聚桂醇注射液|聚桂醇注射液
